伶	龄,冷,铃,另,磷,邻,陵,灵,玲,凝,林,零,临,怜,领,令,凌,岭
悯	命,鸣,明,民,名,敏
逆	黎,厉,梨,理,李,利,立,离,礼,吏,厘,莉,历,哩,隶,你,丽,拟,尼,励,力,里,泥,例,粒,璃
谍	跌,爹,蝶,叠
都	煮,兜,诸,赌,斗,者,抖,堵,署,豆,绪
坪	频,苹,品,凭,平,拼,屏,瓶,萍,贫,评
腮	塞,赛,晒
通	筒,痛,童,桶,涌,统,铜,同
横	冯,风,狠,疯,蜂,衡,恒,锋,缝,很,峰,封,凤,奉,丰,恨,哼,逢,痕
析	晰,戏,袭,近,悉,稀,习,吸,希,席,西,浙,嘻,锡,细,隙,夕,息,溪,牺,系,拆,惜,哲,折,洗,喜,媳,斤
矮	爱,碍,哎,挨,哀,埃,唉,艾
非	菲,黑,匪,肥,排,肺,嘿,废,悲,辈,费,飞,沸
舰	碱,蒋,讲,匠,简,见,减,尖,箭,键,降,姜,航,剪,渐,奖,剑,件,健,建,江,疆,检,坚,将,兼,监,肩,鉴,间,艰,僵,践,奸,歼,浆
帕	怕,陌,白,拍,爬,伯,泊,柏
巷	享,项,宪,显,乡,象,献,鲜,线,香,县,贤,想,现,翔,祥,箱,掀,橡,相,腺,弦,仙,嫌,响,详,险,限,先,纤,陷,像,湘,向,闲
妆	状,壮,赚,转,装,撞,砖,庄,专
仇	凑,愁,筹,臭,丑,抽,瞅,酬,畴
件	碱,蒋,讲,匠,简,见,减,尖,箭,键,降,姜,剪,渐,奖,剑,健,建,江,疆,检,坚,将,兼,监,肩,鉴,间,艰,舰,僵,践,奸,歼,浆
律	绿,津,女,虑,旅,铝,率,履,吕,氯,驴
痊	权,拳,圈,全,劝,泉,券
辛	醒,行,杏,兴,新,辟,信,辞,幸,欣,性,型,辩,宰,心,姓,形,辨,辣,星,刑,避
汇	绘,辉,慧,灰,惠,会,恢,挥,悔,毁,徽,回
柏	摆,拜,怕,陌,白,败,拍,百,伯,泊,帕
题	体,是,踢,堤,替,梯,提
良	梁,凉,谅,娘,链,辆,恋,亮,连,练,炼,联,两,怜,廉,粮,莲,量,帘,脸,狼
债	摘,窄,寨,宰,再,灾,在,载,宅,仔,栽
又	游,友,权,优,由,邮,犹,油,幽,悠,右,忧,有,诱,幼,尤
暑	煮,诉,疏,理,束,数,蔬,淑,署,树,绪,叔,童,宿,枢,肃,输,者,术,属,埋,抒,俗,赌,著,素,书,鼠,熟,都,舒,速,苏,塑,诸,里,述,堵,竖,殊
喻	与,裕,玉,育,愚,誉,语,豫,遇,雨,宇,愉,于,愈,输,渔,预,余,予,欲,寓,域,郁,狱,娱,羽,舆,鱼,御,偷,浴
酒	舅,久,纠,醉,究,救,旧,配,九,酬,就
暮	莫,亩,慕,漠,墓,幕,母,木,牧,姆,模,穆,摸,目
晓	效,萧,硝,销,孝,消,笑,校,小,肖
肯	坑,跟,垦,根,恳
带	呆,代,逮,戴,袋,待,贷
够	扣,钩,多,狗,口,构,沟,移,购,勾
夭	腰,跃,要,耀,药,邀,遥,摇,咬,姚
程	尘,称,沉,惩,城,层,诚,衬,臣,承,呈,趁,曾,陈,成,晨,撑,乘
王	斑,万,汪,琴,往,网,湾,忘,亡,旺,完,玩,顽,班,望,碗,挽,晚,妄,狂,弯
船	川,穿,闯,创,床,串,窗,传,喘
尾	畏,慰,委,胃,惟,威,味,围,危,伟,未,为,位,伪,谓,卫,维,纬,微,魏,喂,唯,违
婆	迫,泊,破,泼,颇,坡
篓	柔,楼,肉,漏
棠	坦,滩,躺,谈,倘,堂,碳,糖,炭,探,贪,坛,塘,汤,唐,趟,叹,摊
呐	钠,辣,拉,娜,蜡,拿,哪,内,啦,那,纳,腊
撩	辽,了,疗,鸟,料,僚,尿,聊
泞	龄,铃,另,您,陵,灵,玲,凝,零,领,令,凌,岭,宁
蹲	敦,顿,吨,盾
卫	畏,慰,委,胃,惟,威,味,围,危,伟,未,为,位,伪,谓,尾,维,纬,微,魏,喂,唯,违
柠	龄,铃,另,您,陵,灵,玲,凝,零,领,令,凌,岭,宁
吼	否,侯,厚,猴,候,后,喉
抚	扶,忽,副,服,湖,富,糊,乎,赋,复,夫,傅,妇,覆,幅,肤,呼,父,佛,辅,伏,付,胡,符,户,互,弗,腹,赴,咐,缚,浮,府,福,护,虎,腐,辐,负,附
侠	夏,夹,下,吓,霞,峡,狭,瞎,辖
瞳	筒,痛,童,桶,通,统,铜,同
举	巨,距,惧,拒,聚,俱,居,据,剧,菊,局,矩,拘,句,具
溜	柳,纽,流,瘤,硫,刘,牛,留,扭,六
恢	绘,辉,汇,毁,灰,碳,炭,回,慧,惠,挥,徽,会,悔
捺	钠,辣,拉,娜,蜡,拿,哪,啦,那,呐,纳,腊
戌	许,序,叙,续,蓄,须,需,徐,虚,吁,绪
之	字,执,肢,滞,址,姿,致,稚,旨,志,泛,直,滋,制,脂,织,支,汁,知,纸,指,资,兹,自,职,止,质,紫,芝,值,智,置,秩,治,子,乏,至,殖,植,只,枝
心	醒,行,杏,兴,新,信,幸,欣,性,型,辛,姓,形,星,刑
弊	闭,笔,比,彼,逼,毕,壁,蔽,鼻,碧,必,币,避,臂
解	借,界,介,截,街,姐,皆,劫,捷,戒,届,杰,接,洁,竭,阶,节,结,揭
描	庙,猫,秒,苗,妙
脐	汽,期,岂,骑,凄,栖,棋,气,奇,齐,旗,起,其,弃,歧,器,企,漆,戚,七,契,启,妻,欺
晾	惊,梁,京,凉,谅,娘,良,链,景,辆,恋,亮,连,练,炼,联,两,怜,廉,粮,掠,莲,量,帘,脸
轰	鸿,哄,洪,红,宏
摇	姚,咬,腰,邀,瑶,要,耀,药,遥
灌	广,贯,馆,惯,宽,官,罐,观,冠,管,关,光,款
梭	所,说,锁,索,缩
逃	挑,陶,涛,萄,桃,兆,讨,淘,套,掏
黎	逆,厉,梨,理,李,利,立,离,礼,吏,厘,莉,历,哩,隶,你,丽,拟,尼,励,力,里,泥,日,例,粒,璃
抠	扣,钩,狗,够,口,构,沟,购,勾
乒	频,苹,品,凭,平,拼,屏,瓶,萍,贫,评
灸	舅,究,旧,久,酒,救,九,纠,就
爆	报,堡,薄,饱,包,保,胞,抱,暴,宝
挪	逻,诺,螺,娜,萝,络,哪,落,那,裸,洛,罗
琼	穷
敞	阐,苍,藏,缠,肠,厂,唱,尝,偿,昌,仓,场,畅,倡,舱,常,禅,颤,产
舔	天,甜,填,田,添
厦	沙,纱,萨,刹,洒,杀,啥,撒,砂,傻
母	亩,木,牧,姆,墓,幕,慕,穆,目
缓	荒,皇,惶,幻,煌,环,欢,援,黄,患,换,晃,暖,慌,唤
肤	抚,扶,忽,副,服,湖,富,糊,乎,赋,复,夫,傅,妇,覆,幅,呼,父,佛,辅,伏,付,胡,符,户,互,弗,腹,赴,咐,缚,浮,府,福,护,虎,腐,辐,负,甫,附
岂	汽,期,骑,凄,栖,棋,气,奇,齐,旗,起,其,弃,歧,器,企,漆,戚,七,契,启,妻,欺
葵	规,跪,鬼,愧,桂,贵,硅,轨,亏,龟,柜,归,溃
个	葛,格,隔,课,歌,棵,哥,可,革,胳,壳,阁,克,各,科,割,渴,客,鸽,颗,刻,戈
钦	轻,庆,琴,侵,晴,请,倾,清,氢,亲,青,情,勤,秦
椿	寸,村,存,醇,纯,唇,春
峡	夏,夹,下,吓,霞,狭,瞎,辖
茉	墨,陌,魔,莫,默,抹,模,漠,膜,摸,磨,摩,末,沫
矾	凡,范,泛,犯,妨,饭,房,寒,反,防,汉,仿,纺,方,罕,贩,函,烦,番,繁,返,翻,喊,涵,韩,放,芳,含,访,旱,汗
志	字,执,肢,滞,址,姿,致,稚,旨,直,滋,制,脂,织,支,汁,知,纸,指,资,兹,自,职,止,质,紫,芝,值,智,之,置,秩,治,子,至,殖,植,只,枝
送	宋,松,耸,颂,讼
蒸	诊,争,整,珍,症,振,政,侦,挣,证,睁,镇,增,阵,郑,真,针,震,贞,正,征
浅	前,千,强,潜,线,迁,钱,歉,残,谦,遣,墙,欠,腔,签,抢,铅,践,牵,枪
辰	辱,尘,称,程,沉,惩,振,唇,城,诚,衬,臣,承,呈,趁,震,陈,成,晨,撑,乘
洛	弱,落,螺,诺,萝,各,络,路,逻,若,裸,罗
秉	饼,兵,冰,滨,并,丙,宾,病
榔	懒,郎,篮,烂,栏,滥,嚷,囊,浪,拦,兰,廊,览,让,蓝,朗,狼,壤
返	凡,范,泛,犯,妨,饭,板,房,寒,反,防,汉,仿,纺,方,罕,贩,函,烦,番,繁,版,翻,喊,涵,韩,放,芳,含,访,旱,汗
猜	才,采,材,柴,裁,晴,蔡,财,清,拆,彩,青,睛,菜,情
深	生,审,渗,婶,伸,升,身,绳,肾,省,什,慎,圣,声,申,牲,神,剩,沈,胜,甚,盛,森
姑	骨,股,故,苦,固,酷,鼓,雇,咕,库,孤,古,枯,谷,哭,裤,顾,估
炕	杠,看,港,康,堪,坑,坎,刊,岗,刚,纲,抗,砍,钢
劈	披,譬,匹,皮,辟,疲,壁,避,屁,脾,批
衰	帅,甩,摔
辨	变,遍,辩,扁,编,鞭,便,边
譬	披,匹,皮,辟,疲,屁,脾,批
漂	票,飘
咳	海,刻,害,核,该,还,孩
堤	底,提,帝,弟,是,递,低,题,抵,蒂,第,滴,迪,敌
庙	描,袖,由,油,抽,邮,迪,秒,苗,妙
虏	努,辱,录,怒,炉,儒,如,露,芦,入,奴,陆,路,鲁,乳,碌,卢,鹿
港	杠,干,康,感,甘,肝,赶,敢,岗,刚,纲,抗,杆,钢,炕
湃	排,牌,拍,派
详	群,享,项,宪,显,乡,象,献,鲜,线,香,县,贤,想,现,翔,祥,洋,箱,样,掀,橡,相,腺,弦,仙,嫌,响,险,限,先,纤,陷,羊,像,湘,向,闲
开	概,慨,改,型,形,钙,盖,刑,溉,该,凯
阻	柱,煮,驻,租,贮,嘱,主,祝,助,筑,珠,宜,足,住,竹,铸,逐,谊,且,组,祖,诸,猪,朱,株,族,注
卖	迈,埋,续,麦,买,读,脉
赶	杠,看,干,港,感,甘,堪,肝,坎,敢,刊,岗,刚,纲,杆,砍,钢
歪	外,证,正,征,症,惩
沿	焰,氧,阳,厌,严,言,养,验,颜,洋,央,样,宴,燕,咽,秧,扬,盐,研,眼,炎,艳,烟,延,演,杨,掩,衍,仰,羊,岩
渝	与,裕,玉,育,愚,誉,语,豫,遇,雨,宇,愉,喻,于,愈,渔,预,余,予,欲,寓,域,郁,狱,娱,羽,舆,鱼,御,浴
位	畏,慰,委,胃,惟,威,味,围,危,伟,未,为,伪,谓,尾,卫,维,纬,微,魏,喂,唯,违
瘫	坦,滩,躺,谈,倘,堂,碳,糖,炭,探,贪,坛,塘,汤,唐,趟,叹,摊
辑	基,挤,集,济,鸡,寂,脊,际,机,既,疾,祭,技,及,吉,迹,级,急,极,积,饥,即,几,击,己,绩,肌,激,忌,计,季,继,寄,籍,剂,记,纪
渐	碱,暂,蒋,讲,匠,简,见,减,尖,箭,键,降,姜,剪,奖,剑,件,健,建,江,疆,检,坚,将,兼,监,肩,鉴,间,艰,舰,僵,践,奸,歼,浆
斤	禁,晰,净,静,惊,金,京,敬,近,精,析,劲,锦,筋,镜,津,浙,晋,境,景,竟,浸,尽,巾,经,井,茎,警,颈,拆,竞,进,仅,睛,哲,折,晶,紧,谨,今,径
贵	规,跪,鬼,愧,桂,硅,轨,亏,龟,柜,遗,归,溃
朋	碰,育,喷,脊,棚,捧,彭,盆,月,膨,蓬,膊,背
异	逸,役,医,抑,毅,义,一,益,议,疑,亦,乙,姨,宜,蚁,椅,移,译,疫,谊,亿,已,衣,依,遗,矣,易,仪,以,艺,伊,意,忆,翼
炉	努,辱,录,怒,儒,如,露,房,芦,入,驴,户,奴,陆,路,鲁,乳,碌,卢,鹿
罚	伐,哈,阀,乏,法,发
究	舅,旧,久,酒,救,九,纠,就
所	说,锁,索,缩
土	涂,徒,途,突,屠,图,兔,吐
黑	菲,匪,肥,墨,肺,非,默,嘿,废,费,飞,沸
藐	描,庙,秒,苗,妙
兴	醒,行,杏,新,信,幸,欣,性,型,辛,心,姓,形,星,刑
睡	髓,虽,税,碎,岁,垂,锤,遂,随,水
鸟	辽,鸣,疗,料,僚,尿,岛,聊,鹅
熟	诉,疏,束,数,蔬,淑,署,树,叔,宿,枢,肃,输,术,属,抒,俗,素,书,鼠,舒,速,苏,塑,述,竖,殊
翩	翔,篇,片,翻,骗,翅,羽,偏
翼	异,逸,役,医,抑,毅,义,一,益,议,疑,亦,乙,姨,宜,蚁,椅,移,译,疫,谊,亿,已,衣,依,遗,矣,易,仪,以,艺,伊,意,忆
望	万,汪,往,网,湾,忘,亡,旺,完,玩,顽,碗,挽,晚,妄,王,弯
檐	焰,氧,阳,厌,严,言,养,验,颜,洋,央,沿,样,宴,燕,咽,秧,扬,盐,研,眼,炎,艳,烟,延,演,杨,掩,衍,仰,羊,岩
哮	效,萧,硝,销,孝,消,笑,晓,校,小,肖
重	忠,仲,纵,终,众,总,宗,种,综,钟,衷,中,踪,肿
鹿	努,辱,录,怒,炉,儒,如,露,芦,入,奴,陆,路,鲁,乳,碌,卢
九	舅,究,旧,久,酒,救,纠,就
酸	算
排	菲,匪,牌,非,悲,拍,辈,派
耽	氮,胆,单,弹,丹,党,但,当,旦,诞,荡,档,淡,挡,蛋,担
流	柳,纽,瘤,硫,刘,牛,留,溜,扭,六
渡	杜,督,赌,独,毒,堵,读,肚,度
册	测,策,彻,车,扯,撤,侧
饶	老,牢,扰,捞,烧,劳,绕
挡	氮,胆,单,弹,丹,党,但,当,旦,诞,荡,档,淡,蛋,担
灾	火,摘,窄,寨,煤,宰,再,在,载,宅,炎,债,烧,仔,栽
屿	与,裕,玉,育,愚,誉,语,豫,遇,雨,宇,愉,喻,于,愈,渔,预,余,予,欲,寓,域,郁,狱,娱,羽,舆,鱼,御,浴
钙	概,慨,改,盖,溉,该,开,凯
蔚	畏,慰,委,胃,惟,威,味,围,危,伟,未,为,位,伪,谓,尾,卫,维,纬,微,魏,喂,唯,违
丽	逆,黎,厉,梨,理,李,利,立,离,礼,吏,厘,莉,历,哩,隶,你,拟,尼,励,力,里,泥,日,例,粒,璃
膀	榜,斑,板,邦,半,傍,伴,帮,班,棒,搬,扮,办,版,颁,旁,般
二	耳,而,尔,儿
吩	冯,风,狠,疯,蜂,份,锋,氛,缝,很,芬,峰,粉,封,凤,奉,丰,粪,奋,恨,愤,逢,分,坟,纷,痕
蝌	葛,格,隔,课,个,歌,棵,哥,可,革,胳,壳,阁,克,各,科,割,渴,客,鸽,颗,刻,戈
偎	畏,慰,委,胃,惟,威,味,围,危,伟,未,为,位,伪,谓,尾,卫,维,纬,微,魏,喂,唯,违
串	患,川,穿,船,闯,创,床,窗,传,喘
贩	凡,范,泛,犯,妨,饭,房,寒,反,防,汉,仿,纺,方,罕,函,烦,番,繁,返,翻,喊,涵,韩,放,芳,含,访,旱,汗
蓝	懒,郎,篮,然,南,烂,难,栏,滥,染,浪,拦,兰,廊,览,临,燃,监,鉴,男,朗,狼
曲	取,屈,趣,驱,渠,躯,区,去,趋
定	顶,丁,叮,盯,钉,订
阳	焰,氧,厌,严,言,养,验,颜,洋,央,沿,样,宴,燕,咽,秧,扬,盐,研,眼,炎,艳,烟,延,演,杨,掩,衍,仰,羊,岩
尚	上,躺,衫,赏,珊,陕,商,丧,善,伤,闪,山,嗓,扇,趟,桑
讲	碱,蒋,匠,简,见,减,尖,箭,键,降,姜,剪,渐,奖,剑,件,健,建,江,疆,检,坚,将,兼,监,肩,鉴,间,艰,舰,僵,践,奸,歼,浆
线	享,项,宪,显,乡,象,献,鲜,香,县,贤,想,现,翔,祥,钱,箱,掀,橡,相,残,腺,弦,仙,嫌,响,详,险,限,先,纤,陷,浅,像,践,湘,向,闲
藏	苍,惨,参,肠,厂,唱,尝,偿,残,昌,仓,蚕,场,畅,倡,舱,常,餐
谊	阻,异,逸,役,医,抑,毅,义,一,益,议,疑,亦,乙,姨,宜,蚁,椅,移,译,疫,且,亿,已,组,衣,依,遗,矣,易,仪,以,艺,伊,意,忆,翼
伸	生,审,渗,婶,升,身,绳,肾,省,什,慎,圣,声,申,牲,神,剩,深,沈,胜,甚,盛,森
箫	效,萧,硝,销,孝,消,笑,晓,校,小,肖
喜	晰,戏,袭,析,悉,稀,习,吸,希,席,西,嘻,锡,细,隙,夕,息,溪,牺,系,惜,洗,媳
叙	序,吁,需,除,绪,许,斜,须,途,徐,余,蓄,涂,续,虚
窑	姚,咬,摇,腰,邀,要,耀,药,遥
坯	披,譬,匹,皮,辟,疲,屁,脾,批
唾	托,拖,驼,脱,妥
尝	阐,苍,藏,缠,肠,厂,唱,偿,昌,仓,场,畅,倡,舱,常,禅,颤,产
绝	掘,觉,决
山	上,衫,赏,珊,陕,三,商,散,善,伤,闪,扇,尚
圆	源,员,元,愿,远,原,渊,怨,援,冤,园,缘,袁,院
吉	基,挤,集,济,鸡,寂,脊,际,机,既,疾,祭,技,及,辑,迹,级,急,极,积,饥,即,几,击,己,绩,肌,激,忌,计,季,继,寄,籍,剂,洁,记,结,纪
捂	物,吴,五,语,乌,雾,舞,屋,无,务,污,悟,午,伍,呜,武,吾,误
峭	敲,瞧,桥,梢,稍,巧,肖,乔,悄,哨,侨,销,硝,消
前	千,强,潜,迁,钱,歉,谦,遣,墙,欠,腔,签,抢,浅,铅,牵,枪
厂	阐,苍,藏,缠,肠,唱,尝,偿,昌,仓,场,畅,倡,舱,常,禅,颤,产
辟	披,脾,壁,辞,皮,辩,宰,辛,譬,匹,辨,疲,辣,避,屁,批
衔	享,项,宪,显,乡,象,献,鲜,线,香,县,贤,想,现,翔,祥,箱,掀,橡,相,腺,弦,仙,嫌,响,详,险,限,先,纤,陷,像,湘,向,闲
丧	散,伤,上,嗓,三,赏,桑,尚,商
萄	陶,涛,桃,讨,淘,套,逃,掏
筒	痛,童,桶,通,统,铜,同
频	苹,品,凭,平,拼,屏,瓶,萍,贫,评
革	葛,格,隔,课,个,歌,棵,哥,可,胳,壳,阁,克,各,科,割,渴,客,鸽,颗,刻,戈
养	焰,氧,阳,厌,严,言,验,颜,洋,央,沿,样,宴,燕,咽,秧,扬,盐,研,眼,炎,艳,烟,延,演,杨,掩,衍,仰,羊,岩
咪	迷,秘,蜜,弥,米,密,泌
称	尘,程,沉,惩,城,层,诚,衬,臣,承,呈,趁,曾,陈,成,晨,撑,乘
孽	劣,裂,猎,捏,烈,咧,列
闽	命,鸣,明,民,名,敏
迪	底,滴,抽,递,低,抵,由,庙,帝,敌,弟,袖,第,油,邮,堤,蒂
旗	汽,期,岂,骑,凄,栖,棋,气,奇,齐,斯,起,其,弃,歧,器,企,漆,戚,七,契,启,妻,欺
潮	巢,超,操,朝,抄,曹,槽,撤,吵,草
潘	判,盼,盘,叛,庞,攀,旁,胖
脏	葬,障,丈,暂,账,胀,赞,帐,掌,仗,张,咱,章,长,涨
纤	享,项,千,宪,显,乡,象,献,鲜,线,香,县,贤,想,现,迁,翔,祥,箱,掀,橡,相,腺,弦,仙,嫌,响,详,险,限,先,陷,像,湘,向,闲
眷	誉,捐,倦,券,卷
俱	巨,距,惧,拒,聚,举,居,据,剧,菊,局,矩,拘,句,具
切	彻,窃,且
唉	矮,爱,碍,哎,挨,哀,埃,艾
模	默,莫,慕,漠,摸,沫,陌,墓,幕,膜,摩,末,墨,魔,抹,磨
椎	摧,吹,垂,脆,锤,催,粹,崔,翠
液	业,叶,野,爷,夜,冶,也,页
辅	抚,扶,忽,副,服,湖,富,糊,铺,乎,赋,复,夫,傅,妇,覆,幅,肤,呼,父,佛,搏,伏,付,胡,符,户,互,弗,腹,赴,咐,缚,浮,捕,府,福,膊,护,虎,腐,辐,负,甫,附
协	鞋,携,谢,斜,写,些,谐,械,歇,邪,卸,苏,泄,胁,办
澡	招,遭,造,罩,爪,灶,找,早,兆,藻,召,照,燥,操,糟,赵
署	煮,诉,疏,束,数,蔬,淑,树,绪,叔,宿,枢,肃,输,者,术,属,抒,俗,赌,素,书,鼠,熟,都,舒,速,苏,塑,诸,述,堵,竖,殊
妇	抚,扶,忽,副,服,湖,富,糊,乎,赋,复,夫,傅,覆,幅,肤,呼,父,佛,辅,伏,付,胡,符,户,互,弗,腹,赴,咐,缚,浮,府,福,护,虎,腐,辐,负,甫,附
胆	氮,坦,单,弹,丹,党,但,当,旦,诞,荡,档,淡,挡,蛋,担
窘	穴,穷,空
奏	州,凑,宙,昼,洲,走,轴,皱,骤,周
讳	绘,辉,慧,灰,惠,会,恢,汇,挥,悔,毁,徽,回
胞	报,堡,薄,爆,饱,包,保,抱,暴,宝
贺	账,合,何,贫,和,喝,赫,河,责,货,贪,财,贝,盒,荷,负,呵,核
阎	焰,氧,阳,厌,严,言,养,验,颜,洋,央,沿,样,宴,燕,咽,秧,扬,盐,研,眼,炎,艳,烟,延,演,杨,掩,衍,仰,羊,岩
偿	阐,苍,藏,缠,肠,厂,唱,尝,昌,仓,场,畅,倡,舱,常,禅,颤,产
曝	爆,扑,铺,葡,仆,朴,暴,谱,普
脱	托,拖,驼,说,悦,妥
三	衫,珊,扇,丧,散,善,闪,陕,桑,山,嗓
贱	碱,线,蒋,讲,匠,简,见,减,钱,尖,箭,键,降,姜,残,剪,渐,奖,剑,件,健,建,江,疆,检,坚,将,兼,监,肩,鉴,间,艰,浅,舰,僵,践,奸,歼,浆
碌	绿,努,辱,录,怒,炉,剥,儒,如,露,逮,芦,入,奴,陆,路,鲁,乳,卢,鹿
岁	髓,虽,税,碎,睡,遂,随,水
鲤	逆,黎,厉,梨,理,李,利,立,离,礼,吏,厘,莉,历,哩,隶,你,丽,拟,尼,励,力,里,泥,日,例,粒,璃
泥	逆,黎,厉,梨,理,李,利,立,离,礼,吏,厘,莉,历,哩,隶,你,丽,拟,尼,励,力,里,例,粒,璃
醒	行,杏,兴,新,信,幸,欣,性,型,辛,心,姓,形,星,刑
瞒	忙,蛮,漫,茫,慢,曼,盲,满
倡	阐,苍,藏,缠,肠,厂,唱,尝,偿,昌,仓,场,畅,舱,常,禅,颤,产
掉	卓,吊,调,雕,桌
卒	阻,柱,煮,驻,租,贮,嘱,主,祝,助,筑,珠,足,住,竹,铸,逐,组,祖,诸,猪,朱,株,族,注
凤	冯,风,疯,蜂,份,衡,恒,氛,锋,缝,芬,峰,粉,封,奉,丰,粪,横,奋,哼,逢,分,坟,纷,愤
愧	规,跪,鬼,桂,贵,硅,轨,亏,龟,魂,柜,归,魏,溃
治	字,执,肢,滞,址,姿,致,稚,旨,志,直,滋,制,脂,织,支,汁,知,纸,指,资,兹,自,职,止,质,紫,芝,值,智,之,置,秩,子,至,殖,植,只,枝
姚	咬,摇,腰,邀,要,耀,药,遥
吾	物,吴,五,语,乌,雾,舞,屋,无,务,污,悟,午,伍,呜,武,误
炒	巢,超,操,朝,抄,曹,槽,吵,草,潮
玩	远,万,汪,往,网,湾,忘,园,亡,元,旺,完,顽,望,碗,挽,晚,妄,王,弯
沈	生,审,渗,婶,伸,升,身,绳,肾,省,什,慎,圣,声,申,牲,神,剩,深,胜,甚,盛,森
昭	招,遭,造,罩,爪,灶,找,早,兆,藻,召,照,燥,糟,赵
框	广,栖,况,狂,木,矿,林,材,村,宽,光,款
聪	匆,从,冲,崇,充,丛,虫
狠	娘,恳,份,衡,垦,恒,氛,很,芬,粉,粪,横,奋,恨,愤,哼,分,坟,纷,痕,狼
薛	穴,学,血,雪,削
齿	词,次,池,瓷,刺,磁,持,驰,此,辞,耻,斥,尺,迟,慈,吃,翅,雌,赤
憎	争,症,政,怎,挣,证,睁,增,郑,僧,蒸,曾,正,征,整
赢	鹰,英,映,姻,吟,影,因,迎,殷,隐,盈,应,印,阴,引,硬,营,颖,婴,音,饮,银
牵	前,千,强,潜,迁,钱,歉,谦,遣,墙,欠,腔,签,抢,浅,铅,枪
饭	凡,范,泛,犯,妨,板,房,寒,反,防,汉,仿,纺,方,罕,贩,函,烦,番,繁,返,版,翻,喊,涵,韩,放,芳,含,访,旱,汗
恤	许,序,叙,续,蓄,须,需,徐,虚,吁,绪
向	享,项,宪,显,乡,象,献,鲜,线,香,县,贤,想,现,翔,祥,箱,掀,橡,相,腺,弦,仙,嫌,响,详,险,限,先,纤,陷,像,湘,闲
卸	鞋,写,些,协,斜,谐,携,械,歇,泄,胁,邪,谢
绳	生,审,渗,婶,伸,升,身,肾,省,什,慎,圣,声,申,牲,神,剩,深,沈,僧,胜,甚,盛
雀	缺,确,却
蛾	恶,鹅,鄂,俄,饿,额
霹	披,譬,匹,皮,辟,疲,屁,脾,批
乎	抚,扶,忽,副,服,湖,富,糊,赋,复,夫,傅,妇,覆,幅,肤,呼,父,佛,辅,伏,付,胡,符,户,互,弗,腹,赴,咐,缚,浮,府,福,护,虎,腐,辐,负,甫,附
妻	汽,期,岂,骑,凄,栖,棋,气,奇,齐,旗,起,其,弃,歧,器,企,漆,戚,七,契,启,欺
赂	努,辱,录,怒,炉,儒,如,露,芦,入,奴,陆,路,鲁,乳,碌,卢,鹿
嗦	所,说,锁,索,缩
骏	峻,军,俊,君,菌,均
教	胶,骄,郊,焦,角,搅,脚,较,缴,交,轿,娇,叫
寸	过,守,村,讨,衬,时,存,醇,对,纯,付,唇,春
李	逆,黎,厉,梨,理,利,立,离,礼,吏,厘,莉,历,哩,隶,你,丽,拟,尼,励,力,里,泥,日,例,粒,璃
凉	惊,梁,京,谅,娘,良,链,景,辆,恋,亮,连,练,炼,联,两,怜,廉,粮,掠,莲,量,帘,脸
蕊	瑞,锐
匕	闭,笔,比,彼,逼,毕,壁,蔽,鼻,碧,必,币,弊,避,臂
厢	享,项,宪,显,乡,象,献,鲜,线,香,县,贤,想,现,翔,祥,箱,掀,橡,相,腺,弦,仙,嫌,响,详,险,限,先,纤,陷,像,湘,向,闲
次	词,池,齿,姿,瓷,刺,磁,持,驰,此,辞,耻,资,斥,尺,迟,慈,吃,翅,雌,赤
焊	凡,含,范,杭,泛,犯,饭,寒,反,汉,航,贩,罕,烦,番,繁,返,翻,喊,涵,韩,函,旱,汗
骇	海,害,咳,还,孩
轻	庆,琴,侵,晴,请,倾,清,氢,亲,青,情,勤,秦
强	前,千,潜,迁,钱,歉,谦,遣,墙,欠,腔,签,抢,浅,铅,牵,枪
智	字,执,肢,滞,址,姿,致,稚,旨,志,直,滋,制,脂,织,支,汁,知,纸,指,资,兹,自,职,止,质,紫,芝,值,之,置,秩,治,子,至,殖,植,只,枝
感	杠,看,干,港,甘,堪,肝,赶,坎,敢,刊,岗,刚,纲,杆,砍,钢
企	汽,期,岂,骑,凄,栖,棋,气,奇,齐,旗,起,其,弃,歧,器,漆,戚,七,契,启,妻,欺
甚	生,审,渗,婶,伸,堪,升,身,绳,肾,省,什,慎,圣,声,申,牲,神,剩,深,沈,胜,盛,森
喉	否,侯,厚,猴,候,后
既	基,挤,概,集,济,鸡,寂,脊,际,机,疾,祭,技,及,辑,吉,溉,迹,级,急,极,积,饥,即,几,击,己,绩,肌,激,忌,计,季,继,慨,寄,籍,剂,记,纪
姜	碱,蒋,讲,匠,简,见,减,尖,箭,键,降,剪,渐,奖,剑,件,健,建,江,疆,检,坚,将,兼,监,肩,鉴,间,艰,舰,僵,践,奸,歼,浆
连	梁,凉,谅,良,链,辆,恋,亮,练,炼,联,两,怜,廉,粮,念,莲,年,量,帘,脸
毁	绘,辉,慧,灰,惠,会,恢,汇,挥,悔,徽,回
迢	跳,条,挑
昌	阐,苍,藏,缠,肠,厂,唱,尝,偿,仓,场,畅,倡,舱,常,禅,颤,产
列	劣,裂,猎,捏,烈,例,咧
沪	抚,扶,忽,副,服,湖,富,糊,乎,赋,复,夫,傅,妇,覆,幅,肤,呼,父,佛,辅,伏,付,胡,符,户,互,弗,腹,赴,咐,缚,浮,府,福,护,虎,腐,辐,负,甫,附
恨	娘,狠,恳,份,衡,垦,恒,氛,很,芬,粉,粪,横,奋,愤,哼,分,坟,纷,痕,狼
赋	抚,扶,忽,副,服,湖,富,糊,乎,复,夫,傅,妇,覆,幅,肤,呼,父,佛,辅,伏,付,胡,符,户,互,弗,腹,赴,咐,缚,浮,府,福,护,虎,腐,辐,负,甫,附
检	碱,蒋,讲,匠,简,验,见,减,尖,箭,键,降,姜,剪,渐,奖,剑,件,健,建,江,疆,坚,将,兼,监,签,肩,鉴,险,间,艰,舰,僵,践,奸,脸,歼,浆
嘿	菲,黑,匪,肥,肺,非,废,费,飞,沸
媚	没,美,妹,梅,枚,煤,每,霉,眉,媒
掩	焰,氧,阳,厌,严,言,养,验,颜,洋,央,沿,样,宴,燕,咽,秧,俺,扬,盐,研,眼,炎,艳,烟,延,演,杨,衍,仰,羊,岩
始	市,实,司,寺,尸,四,使,拾,室,适,食,世,私,是,施,逝,势,死,识,师,石,试,诗,释,蚀,斯,撕,十,湿,思,式,似,士,示,氏,丝,史,事,饲,视,驶,时,饰,失
蜈	物,吴,五,乌,雾,舞,屋,无,务,污,悟,午,伍,呜,武,吾,误
籽	字,执,肢,滞,址,姿,致,稚,旨,志,直,滋,制,脂,织,支,汁,知,纸,指,资,兹,自,职,止,质,紫,芝,值,智,之,置,秩,治,子,至,殖,植,只,枝
墓	莫,亩,慕,漠,幕,母,木,牧,姆,模,穆,摸,目
释	市,实,司,寺,尸,四,使,拾,室,适,食,世,私,是,施,逝,势,死,识,师,石,试,诗,始,蚀,斯,撕,十,湿,思,式,似,士,示,氏,丝,史,事,饲,视,驶,时,饰,失
豹	报,堡,薄,爆,饱,包,保,胞,抱,暴,宝
懊	傲,奥,澳,凹
爸	拔,八,坝,叭,吧,霸,罢,把,巴
闸	咋,炸,杂,扎
皇	荒,缓,惶,幻,煌,环,欢,黄,患,换,晃,慌,唤
观	觉,现,广,贯,惯,见,罐,宽,光,官,冠,管,灌,关,款,馆,视
遣	前,千,强,潜,迁,钱,歉,谦,墙,欠,腔,签,抢,浅,铅,牵,枪
尴	杠,看,干,港,感,甘,堪,肝,赶,坎,敢,刊,岗,刚,纲,杆,砍,钢
啃	坑,跟,垦,肯,根,恳
浮	抚,扶,忽,副,服,湖,富,糊,乎,赋,复,夫,傅,妇,覆,幅,肤,呼,父,佛,辅,伏,付,胡,符,户,互,弗,腹,赴,咐,缚,府,福,护,虎,腐,辐,负,甫,附
肇	招,遭,造,罩,爪,灶,找,早,兆,藻,召,照,燥,糟,赵
记	基,挤,集,济,鸡,寂,脊,际,机,既,疾,祭,技,及,辑,吉,迹,级,急,极,积,饥,即,几,击,己,绩,肌,激,忌,计,季,继,寄,籍,剂,纪
巧	侨,乔,悄,敲,桥,瞧
基	挤,集,济,鸡,寂,脊,际,机,既,疾,祭,技,及,辑,吉,迹,级,急,极,积,饥,即,几,击,己,绩,肌,激,忌,计,季,继,寄,籍,剂,记,纪
斗	兜,料,抖,豆,科,都
蜓	停,艇,亭,庭,听,厅,廷,挺
蜗	窝,我,卧,握
誉	与,裕,玉,育,愚,语,豫,遇,雨,宇,卷,愉,喻,倦,于,愈,渔,券,预,余,予,欲,寓,域,郁,狱,娱,羽,舆,鱼,御,浴
途	涂,除,余,斜,土,徒,叙,突,屠,图,兔,徐,吐
灿	阐,苍,藏,缠,惨,参,残,仓,蚕,禅,颤,舱,餐,产
玻	披,博,剥,彼,伯,拨,勃,脖,播,波,搏,被,坡,皮,驳,皱,膊,疲,破,卜
数	诉,疏,束,蔬,淑,署,楼,树,叔,宿,枢,肃,输,术,属,抒,俗,素,书,鼠,熟,舒,速,苏,塑,述,竖,殊
娱	与,吴,裕,玉,育,愚,誉,语,豫,遇,雨,宇,愉,喻,于,愈,渔,预,余,予,欲,寓,域,郁,狱,羽,舆,鱼,御,浴,误
利	逆,黎,厉,梨,理,李,立,离,礼,吏,厘,莉,历,哩,隶,你,丽,拟,尼,励,力,里,泥,日,例,粒,璃
兹	字,执,肢,滞,址,姿,致,稚,旨,志,磁,直,滋,制,脂,织,支,汁,知,纸,指,资,自,职,止,质,紫,芝,值,智,之,置,慈,秩,治,子,至,殖,植,只,枝
补	不,布,扑,步,仆,朴,捕,部,卜
庚	坑,跟,耕,更,根
丰	冯,风,疯,蜂,份,衡,恒,氛,锋,缝,芬,峰,粉,封,凤,奉,粪,横,奋,哼,逢,分,坟,纷,愤
蚣	功,宫,控,巩,工,孔,贡,弓,供,空,共,公,攻,恐,恭
晚	逸,万,汪,往,网,湾,忘,亡,勉,旺,完,玩,免,顽,望,碗,挽,妄,王,弯
拟	逆,黎,厉,梨,理,李,利,立,离,礼,吏,厘,莉,历,哩,隶,你,丽,尼,励,力,里,泥,例,粒,璃
坐	卓,作,桌,捉,做,左,昨,座
芒	亡,忙,蛮,漫,茫,慢,曼,盲,满
歉	前,千,强,潜,迁,钱,谦,遣,墙,嫌,欠,腔,廉,兼,签,赚,抢,浅,铅,牵,枪
猿	源,员,元,愿,远,原,渊,怨,圆,援,冤,园,缘,袁,院
骨	姑,股,故,苦,滑,固,酷,鼓,雇,咕,库,孤,古,枯,谷,哭,裤,顾,估
麦	迈,卖,埋,买,脉
皂	招,遭,造,罩,爪,灶,找,早,兆,藻,召,照,燥,糟,赵
叽	基,挤,集,济,鸡,寂,脊,际,机,既,疾,祭,技,及,辑,吉,迹,级,急,极,积,饥,即,几,击,己,绩,肌,激,忌,计,季,继,寄,籍,剂,记,纪
昨	卓,作,桌,炸,捉,做,左,座,坐
铝	绿,宫,女,虑,旅,率,履,吕,律,氯,驴
浪	懒,郎,篮,烂,栏,滥,嚷,囊,拦,兰,廊,览,让,蓝,朗,狼,壤
词	次,池,齿,瓷,刺,磁,持,驰,此,辞,耻,斥,尺,迟,慈,吃,翅,雌,赤
汤	坦,滩,躺,谈,倘,堂,碳,糖,肠,炭,探,贪,坛,塘,扬,场,杨,唐,趟,叹,摊
敲	侨,乔,悄,巧,桥,瞧
河	喝,盒,合,何,贺,荷,赫,呵,核,和
对	寸,过,守,队,村,讨,堆,衬,时,付
吓	夏,下,霞,峡,狭,瞎,辖
矛	茅,貌,帽,冒,毛,茂,贸,猫
邓	灯,瞪,凳,登,等
殊	诉,疏,束,数,蔬,淑,署,树,叔,宿,枢,肃,输,术,属,抒,俗,素,书,鼠,熟,舒,速,苏,塑,述,竖
慎	生,审,渗,婶,伸,升,身,绳,肾,填,省,什,圣,声,申,牲,神,剩,深,沈,真,胜,甚,盛,森
暴	报,堡,薄,爆,饱,包,保,胞,抱,宝
鳖	别,弊,蔽
疼	藤,疗,病,瘦,腾
锚	茅,貌,帽,冒,毛,茂,贸,猫,矛
帘	梁,凉,谅,良,链,辆,恋,亮,连,练,炼,联,两,怜,廉,粮,念,莲,年,量,脸
伪	畏,慰,委,胃,惟,威,味,围,危,伟,未,为,位,谓,尾,卫,维,纬,微,魏,喂,唯,违
榜	斑,板,邦,膀,半,傍,伴,帮,班,棒,搬,扮,办,版,颁,旁,般
撕	市,实,司,寺,尸,四,使,拾,室,适,食,世,私,是,施,逝,势,死,识,师,石,试,诗,始,释,蚀,斯,十,湿,思,式,似,士,示,氏,丝,史,事,饲,视,驶,时,饰,失
辱	录,炉,儒,振,如,唇,露,芦,入,陆,路,震,鲁,晨,乳,碌,卢,鹿
肃	诉,疏,束,数,蔬,淑,署,树,叔,宿,枢,输,术,属,抒,俗,素,书,鼠,熟,舒,速,苏,塑,述,竖,殊
且	组,阻,切,窃,谊,宜
蟋	晰,戏,袭,析,悉,稀,习,吸,希,席,西,嘻,锡,细,隙,夕,息,溪,牺,系,惜,洗,喜,媳
泪	蕾,类,勒,雷,内,累
肠	阐,苍,藏,缠,厂,唱,尝,偿,昌,仓,扬,场,畅,倡,舱,常,禅,颤,杨,汤,产
岸	暗,氨,俺,案,按,昂,安
言	焰,氧,阳,厌,严,养,验,颜,洋,央,沿,样,宴,燕,咽,秧,扬,盐,研,眼,炎,艳,烟,延,演,杨,掩,衍,仰,羊,岩
赏	上,衫,珊,陕,商,丧,善,伤,闪,山,嗓,扇,桑,尚
病	疗,并,滨,疼,兵,瘦,饼,冰,宾,丙
洗	晰,戏,袭,析,悉,稀,习,吸,希,席,西,嘻,锡,细,隙,夕,息,溪,牺,系,惜,喜,媳
咄	屈,躲,多,出,掘,夺,朵
朴	扑,铺,葡,仆,补,谱,普,卜
碗	万,汪,往,网,湾,忘,亡,旺,完,玩,顽,望,挽,晚,妄,王,弯
葱	匆,从,聪,冲,崇,充,丛,虫
熏	训,讯,旬,寻,迅,询,逊,循,巡
敦	顿,蹲,吨,盾
扣	钩,狗,够,口,构,沟,购,勾
踏	她,它,塔,拓,他
抡	论,轮,润,伦
要	腰,妥,耀,药,邀,遥,摇,女,咬,姚
弓	功,宫,控,巩,工,孔,贡,供,空,共,公,攻,恐,恭
臊	稍,扫,梢,少,嫂,绍,哨,烧
卵	软,乱,暖
经	禁,净,静,惊,金,京,敬,近,精,劲,锦,筋,镜,津,晋,境,景,竟,浸,尽,巾,井,茎,警,颈,竞,进,仅,睛,晶,紧,谨,今,径,斤
禄	努,辱,录,怒,炉,儒,如,露,芦,入,奴,陆,路,鲁,乳,碌,卢,鹿
乱	括,刮,软,舌,暖,卵
啄	卓,作,桌,捉,做,逐,左,昨,座,坐
亲	轻,庆,琴,侵,晴,请,倾,清,氢,青,情,勤,秦
伺	词,次,池,齿,瓷,刺,磁,持,驰,此,辞,耻,斥,尺,迟,慈,吃,翅,雌,赤
御	与,裕,玉,育,愚,誉,语,豫,遇,雨,宇,愉,喻,于,愈,渔,预,余,予,欲,寓,域,郁,狱,娱,羽,舆,鱼,浴
淡	氮,胆,单,弹,丹,党,但,当,旦,诞,荡,档,挡,蛋,担
录	绿,努,辱,怒,炉,剥,儒,如,露,逮,芦,入,奴,陆,路,鲁,乳,碌,卢,鹿
宇	与,裕,玉,育,愚,誉,语,吁,豫,遇,雨,愉,喻,于,愈,渔,预,余,予,欲,寓,域,郁,狱,娱,羽,舆,鱼,御,浴
筹	凑,仇,愁,涛,铸,臭,丑,寿,抽,瞅,酬,畴
揽	懒,郎,篮,然,南,烂,难,栏,滥,染,浪,拦,兰,廊,览,燃,蓝,男,朗,狼
构	扣,钩,狗,够,口,沟,购,勾
乍	作,咋,炸,杂,昨,扎
奴	努,录,鲁,露,怒,炉,路,鹿,芦,碌,卢,陆
除	促,畜,触,粗,斜,叙,途,徐,储,初,出,余,厨,处,础,涂,楚
剧	巨,距,惧,拒,聚,俱,举,居,据,菊,局,矩,拘,句,具
练	梁,凉,谅,良,链,辆,恋,亮,连,炼,联,两,怜,廉,粮,念,莲,年,量,帘,脸
放	凡,范,杭,泛,犯,妨,饭,房,反,仿,航,纺,方,贩,烦,番,繁,返,翻,芳,防,访
孟	监,蒙,萌,猛,盒,盐,门,们,梦,盟,闷,盆
翻	凡,范,泛,犯,妨,翔,饭,房,寒,反,防,汉,仿,纺,方,罕,贩,翅,函,烦,番,繁,羽,返,喊,涵,韩,放,芳,含,访,旱,汗
扭	柳,纽,流,瘤,丑,硫,刘,牛,留,溜,六
变	亦,遍,蛮,辩,扁,编,辨,鞭,恋,便,迹,边
思	市,实,司,寺,尸,四,使,拾,室,适,食,世,私,是,施,逝,势,死,识,师,石,试,诗,始,释,蚀,斯,撕,十,湿,式,似,士,示,氏,丝,史,事,饲,视,驶,时,饰,失
陆	努,辱,录,怒,炉,儒,如,露,芦,入,奴,路,鲁,乳,碌,卢,鹿
乞	汽,期,岂,骑,凄,栖,棋,气,奇,齐,旗,起,其,弃,歧,器,企,漆,戚,七,契,启,妻,欺
逐	阻,柱,煮,驻,租,贮,嘱,主,祝,助,筑,珠,足,住,竹,铸,组,祖,诸,猪,朱,株,族,注
礁	胶,骄,郊,焦,角,搅,脚,较,缴,教,交,轿,娇,叫
镜	禁,净,静,惊,金,京,敬,近,精,劲,锦,筋,津,晋,境,景,竟,浸,尽,巾,经,井,茎,警,颈,竞,进,仅,睛,晶,紧,谨,今,径,斤
兔	涂,土,徒,途,突,屠,图,吐
弄	农,拢,笼,浓,龙,隆,垄
宅	摘,窄,寨,宰,再,灾,在,载,债,仔,栽
挂	刮,娃,瓜,夸,佳,封,寡,桂,蛙,跨,崖
瞧	侨,乔,悄,敲,巧,桥
沮	巨,距,惧,拒,聚,俱,举,居,据,剧,菊,局,矩,拘,句,具
芽	押,雅,压,哑,鸦,鸭,崖,牙,呀,亚
但	氮,胆,坦,单,弹,丹,党,当,旦,诞,荡,档,淡,挡,蛋,担
青	轻,庆,琴,侵,晴,请,倾,清,猜,氢,亲,睛,情,勤,秦
屈	取,趣,驱,出,渠,掘,躯,区,去,曲,趋
迎	鹰,英,映,姻,吟,赢,影,因,殷,隐,盈,应,印,阴,引,硬,营,颖,婴,音,饮,银
帐	葬,账,展,粘,章,长,占,掌,涨,脏,障,仗,张,战,沾,丈,胀,站
胚	培,配,佩,赔,陪
匿	逆,黎,厉,梨,理,李,利,立,离,礼,吏,厘,莉,历,哩,隶,你,丽,拟,尼,励,力,里,泥,例,粒,璃
跑	泡,饱,包,抛,抱,炮
扬	焰,氧,阳,厌,严,言,养,验,颜,洋,央,沿,样,肠,宴,燕,咽,秧,盐,研,场,眼,炎,艳,烟,延,演,杨,掩,衍,汤,仰,羊,岩
岖	取,屈,趣,驱,渠,欧,躯,区,去,曲,趋
先	享,项,宪,显,乡,象,献,鲜,线,香,县,贤,想,现,翔,祥,箱,掀,橡,相,腺,弦,仙,嫌,响,详,险,限,纤,陷,像,湘,向,闲
麻	马,蚂,魔,嘛,吗,妈,码,玛,磨,摩,骂
冥	命,鸣,明,民,名,敏
顾	姑,骨,股,故,苦,固,酷,鼓,雇,咕,库,孤,古,枯,谷,哭,裤,估
姨	异,逸,役,医,抑,毅,义,一,益,议,疑,亦,乙,宜,蚁,椅,移,译,疫,谊,亿,已,衣,依,遗,矣,易,仪,以,艺,伊,意,忆,翼
买	迈,卖,埋,麦,脉
嗅	修,羞,绣,袖,秀,休,朽
父	抚,扶,忽,副,服,湖,富,糊,乎,赋,复,夫,傅,妇,覆,幅,肤,呼,佛,辅,伏,付,胡,符,户,互,弗,腹,赴,咐,缚,浮,府,福,护,虎,腐,辐,负,甫,附
征	诊,争,整,珍,症,振,惩,政,侦,挣,证,睁,镇,歪,增,阵,郑,真,针,蒸,震,贞,正
效	萧,硝,销,孝,消,笑,晓,校,小,肖
絮	许,序,叙,续,蓄,须,需,徐,虚,吁,绪
困	昆,棍,滚
砌	汽,期,岂,骑,凄,栖,棋,气,奇,齐,旗,起,其,弃,歧,器,彻,企,漆,切,戚,七,契,启,妻,欺
荔	逆,黎,厉,梨,理,李,利,立,离,礼,吏,厘,莉,历,哩,隶,你,丽,拟,尼,励,力,里,泥,日,例,粒,璃
易	异,逸,役,医,抑,毅,义,一,益,议,疑,亦,踢,乙,姨,宜,蚁,椅,移,锡,译,疫,谊,亿,已,衣,依,遗,矣,仪,以,艺,伊,意,忆,翼
泳	庸,用,涌,拥,永,勇,脉
渣	咋,查,炸,杂,扎
蜡	猎,拉,借,哪,那,腊,娜,拿,呐,钠,惜,辣,错,措,啦,纳
优	游,友,由,又,邮,犹,油,幽,悠,右,忧,有,诱,幼,尤
芹	轻,庆,琴,侵,晴,请,倾,清,氢,亲,青,情,勤,秦
斟	诊,争,整,珍,症,振,堪,政,怎,挣,侦,证,料,睁,镇,科,阵,郑,斗,真,针,抖,蒸,震,甚,贞,正,征
虾	夏,下,吓,霞,峡,狭,瞎,辖
肴	姚,咬,摇,腰,邀,要,耀,药,遥
今	禁,净,静,惊,金,京,敬,近,精,劲,锦,吟,筋,镜,津,晋,境,景,竟,浸,尽,巾,经,贪,井,茎,警,颈,竞,念,进,仅,睛,晶,紧,谨,径,斤
磊	泪,蕾,类,勒,雷,内,累
情	轻,庆,琴,侵,晴,请,倾,清,猜,氢,亲,青,睛,勤,秦
篇	遍,片,扁,编,骗,偏
痹	闭,笔,比,彼,逼,毕,壁,蔽,鼻,碧,必,币,弊,避,臂
吃	词,次,池,齿,瓷,刺,磁,持,驰,此,辞,耻,斥,尺,迟,慈,翅,雌,赤
糟	招,遭,造,罩,爪,灶,找,早,槽,兆,藻,召,照,燥,曹,赵
仅	禁,净,静,惊,金,京,敬,近,精,劲,锦,筋,镜,津,晋,境,景,竟,浸,尽,巾,经,井,茎,警,颈,竞,进,睛,晶,紧,谨,今,径,斤
绅	生,审,渗,婶,伸,升,身,绳,肾,省,什,慎,圣,声,申,牲,神,剩,深,沈,胜,甚,盛,森
南	懒,蓝,难,栏,览,滥,男,篮,囊,拦,兰,烂
楼	柔,数,肉,漏
偶	欧
柿	市,实,司,寺,尸,四,使,拾,室,适,食,世,私,是,施,逝,势,死,识,师,石,试,诗,始,释,蚀,斯,撕,十,湿,思,式,似,士,示,氏,丝,闹,史,事,饲,视,驶,时,饰,失
琉	柳,纽,流,瘤,硫,刘,牛,留,溜,扭,六
涵	凡,含,范,杭,泛,犯,饭,寒,反,汉,航,贩,罕,烦,番,繁,返,翻,喊,韩,函,旱,汗
脖	玻,拨,勃,博,播,膊,波,剥,驳,搏,伯,卜
加	驾,夹,架,家,嫁,佳,钾,甲,假,嘉,贾,稼,价
竭	借,界,喝,介,截,街,渴,姐,皆,劫,捷,戒,届,杰,接,洁,阶,节,结,解,揭
配	胚,培,醉,佩,赔,陪,酬,酒
幌	荒,缓,皇,惶,幻,煌,环,欢,黄,患,换,晃,慌,唤
搀	逸,阐,缠,惨,参,肠,厂,唱,尝,偿,残,昌,勉,蚕,场,畅,倡,常,禅,颤,免,餐,挽,晚,产
吊	调,雕,掉
中	忠,仲,纵,终,众,重,总,宗,种,综,钟,衷,踪,肿
腹	抚,扶,忽,副,服,湖,富,糊,乎,赋,复,夫,傅,妇,覆,幅,肤,呼,父,佛,辅,伏,付,胡,符,户,互,弗,赴,咐,缚,浮,府,福,护,虎,腐,辐,负,附
受	收,搜,瘦,售,兽,守,首,寿,手,授
暗	氨,岸,俺,案,按,昂,安
寇	扣,钩,狗,够,口,构,沟,购,勾
侵	轻,庆,琴,晴,请,倾,清,氢,亲,青,情,勤,秦
否	侯,厚,猴,候,后,喉
岛	鸣,盗,倒,鸟,鹅,稻,导,蹈,刀,到,道
栏	懒,郎,篮,然,南,烂,难,滥,染,浪,拦,兰,廊,览,燃,蓝,男,朗,狼
洼	娃,哇,封,佳,桂,崖,挂,挖,瓦,蛙
骂	马,蚂,嘛,驱,吗,麻,驰,妈,码,驼,玛
矿	广,况,狂,框,宽,光,款
辽	疗,鸟,料,僚,尿,聊
蝎	鞋,写,些,协,卸,斜,谐,携,械,歇,泄,胁,邪,谢
斧	抚,扶,忽,副,服,湖,富,糊,乎,赋,复,夫,傅,妇,覆,幅,肤,呼,父,佛,辅,伏,付,胡,符,户,互,弗,腹,赴,咐,缚,浮,府,福,护,虎,腐,辐,负,甫,附
嗡	温,吻,翁,文,纹,稳,问,闻
窜	患,川,船,穿,传,串,喘
煎	碱,蒋,讲,匠,简,见,减,尖,箭,键,降,姜,剪,渐,奖,剑,件,健,建,江,疆,检,坚,将,兼,监,肩,鉴,间,艰,舰,僵,践,奸,歼,浆
君	群,裙,峻,军,俊,菌,均
愣	冷,能,仍,扔
结	借,界,介,截,吉,街,姐,皆,劫,捷,戒,届,杰,接,洁,竭,阶,节,解,揭
近	禁,晰,净,静,惊,金,京,敬,精,析,劲,锦,筋,镜,津,浙,晋,境,景,竟,浸,尽,巾,经,井,茎,警,颈,拆,竞,进,仅,睛,哲,折,晶,紧,谨,今,径,斤
膨	棚,碰,朋,喷,捧,彭,盆,蓬
芜	物,吴,五,乌,雾,舞,屋,无,务,污,悟,午,伍,呜,武,吾,误
宣	悬,恒,选,旋,玄
蔽	闭,笔,比,彼,逼,毕,壁,鼻,碧,必,币,弊,避,臂
眠	勉,面,棉,免,绵
襟	禁,净,静,惊,金,京,敬,近,精,劲,锦,筋,镜,津,晋,境,景,竟,浸,尽,巾,经,井,茎,警,颈,竞,进,仅,睛,晶,紧,谨,今,径,斤
躬	功,宫,控,巩,工,孔,贡,弓,供,空,共,公,攻,恐,恭
提	体,是,踢,堤,替,题,梯
亡	忙,万,汪,往,网,湾,忘,旺,完,玩,顽,望,碗,挽,晚,妄,王,弯
只	字,执,肢,滞,址,姿,致,稚,旨,志,直,滋,制,脂,织,支,汁,知,纸,识,指,资,兹,自,职,止,质,紫,芝,值,智,之,置,秩,治,子,至,殖,植,枝
杯	贝,卑,北,背,悲,碑,备,被,辈,倍
缩	宿,所,说,锁,索
汝	辱,录,炉,儒,如,露,芦,入,陆,路,鲁,乳,碌,卢,鹿
看	干,康,感,堪,甘,肝,赶,坎,敢,刊,抗,杆,砍,炕
庇	闭,笔,比,彼,逼,毕,壁,蔽,鼻,碧,必,币,弊,避,臂
嚎	耗,豪,浩,好,号,毫
鲸	禁,净,静,惊,金,京,敬,近,精,鲜,劲,锦,筋,镜,津,晋,境,景,竟,浸,尽,巾,经,井,茎,警,颈,竞,进,仅,睛,鱼,晶,紧,谨,今,径,斤
寝	轻,庆,琴,侵,晴,请,倾,清,氢,亲,青,情,勤,秦
脊	基,挤,育,集,济,鸡,寂,际,机,既,疾,祭,技,及,辑,吉,月,迹,级,急,极,积,饥,即,几,击,己,绩,肌,激,忌,计,季,继,寄,籍,朋,膊,剂,背,记,纪
傻	沙,纱,萨,刹,洒,杀,啥,撒,厦,砂
焰	氧,阳,厌,严,言,养,验,颜,洋,央,沿,样,宴,燕,咽,秧,扬,盐,研,眼,炎,艳,烟,延,演,杨,掩,衍,仰,羊,岩
栗	逆,黎,厉,梨,理,李,利,立,离,礼,吏,厘,莉,历,哩,隶,你,丽,拟,尼,励,力,里,泥,日,例,粒,璃
姥	老,闹,牢,扰,捞,脑,恼,劳,饶,绕
鸥	偶,欧
石	市,实,司,寺,尸,四,使,拾,室,适,食,世,私,是,施,逝,势,死,识,师,试,诗,始,释,蚀,斯,撕,十,湿,思,式,似,士,示,氏,丝,史,事,饲,视,驶,时,饰,失
恰	答,给,塔,搭,哈,合,拾
俐	逆,黎,厉,梨,理,李,利,立,离,礼,吏,厘,莉,历,哩,隶,你,丽,拟,尼,励,力,里,泥,日,例,粒,璃
赐	词,次,池,齿,瓷,刺,磁,持,驰,踢,此,辞,耻,锡,斥,尺,易,迟,慈,吃,翅,雌,赤
窝	我,卧,握
聂	劣,裂,猎,捏,烈,咧,列
睦	亩,木,牧,姆,墓,幕,慕,穆,目,母
味	畏,慰,委,胃,惟,威,围,危,伟,未,为,位,伪,谓,尾,卫,维,纬,微,魏,喂,唯,违
钻	赚,砖,专,转
显	享,项,宪,乡,象,献,鲜,线,香,县,贤,想,现,翔,祥,箱,掀,橡,相,腺,弦,仙,嫌,响,详,险,限,先,纤,陷,像,湘,向,闲
芭	爸,拔,八,坝,叭,吧,霸,罢,把,巴
莺	鹰,英,映,姻,吟,赢,影,因,迎,殷,隐,鹅,盈,应,印,阴,引,硬,鸟,营,颖,婴,鸣,音,饮,岛,银
欢	荒,缓,坎,皇,惶,幻,煌,环,吹,欠,黄,患,换,晃,饮,慌,唤
锰	蒙,萌,猛,门,们,梦,盟,闷,孟
悼	卓,盗,倒,岛,稻,导,蹈,刀,到,掉,桌,道
贰	耳,而,尔,儿,二
驯	训,讯,旬,寻,迅,询,逊,循,巡
欣	醒,行,杏,兴,新,信,幸,性,型,辛,心,姓,形,星,刑
接	借,界,介,截,街,姐,皆,劫,捷,戒,届,杰,洁,竭,阶,节,结,解,揭
暂	沾,占,葬,渐,展,赞,粘,站,咱,战,脏
鲨	沙,纱,萨,刹,洒,杀,啥,撒,厦,砂,傻
钝	敦,顿,蹲,吨,盾
秃	涂,土,徒,途,突,屠,图,兔,吐
芙	抚,扶,忽,副,服,湖,富,糊,乎,赋,复,夫,傅,妇,覆,幅,肤,呼,父,佛,辅,伏,付,胡,符,户,互,弗,腹,赴,咐,缚,浮,府,福,护,虎,腐,辐,负,甫,附
食	市,实,司,寺,尸,四,使,拾,室,适,世,私,是,施,逝,势,死,识,师,石,试,诗,始,释,蚀,斯,撕,十,湿,思,式,似,士,示,氏,丝,史,事,饲,视,驶,时,饰,失
才	彩,采,菜,材,财,柴,裁,蔡,猜,拆
调	吊,雕,掉,周
贾	驾,夹,架,家,嫁,佳,钾,甲,假,加,嘉,稼,价
粹	摧,吹,垂,脆,锤,催,崔,翠
亮	梁,凉,谅,娘,良,链,辆,恋,连,练,炼,联,两,怜,廉,粮,莲,量,帘,脸
求	球,丘,秋
陵	淋,龄,铃,另,磷,邻,灵,玲,凝,林,零,临,领,令,凌,岭,宁
睐	奈,赖,莱,来,乃,奶,耐
厉	逆,黎,梨,理,李,利,立,离,礼,吏,厘,莉,历,哩,隶,你,丽,拟,尼,励,力,里,泥,日,例,粒,璃
梦	禁,蒙,萌,猛,楚,门,们,林,盟,闷,孟
幢	川,童,穿,船,闯,撞,创,床,串,窗,传,喘
臣	尘,称,程,沉,惩,城,诚,衬,承,呈,趁,陈,成,晨,撑,乘
荤	婚,浑,魂,昏,混
猪	阻,柱,煮,驻,租,贮,嘱,主,祝,助,筑,珠,足,住,竹,铸,逐,组,祖,诸,朱,株,族,注
琳	淋,龄,铃,另,您,磷,邻,陵,灵,玲,林,零,临,领,令,凌,岭
哲	晰,这,择,浙,著,折,拆,近,者,遮,责,则,析,泽,着,斤
潇	效,萧,硝,销,孝,消,笑,晓,校,小,肖
留	柳,纽,流,瘤,硫,刘,牛,溜,扭,六
窗	川,穿,船,闯,创,床,串,传,喘
壮	状,赚,转,装,撞,砖,庄,专
目	亩,木,牧,姆,墓,幕,慕,穆,母
佳	假,挂,崖,家,娃,桂,甲,加,蛙,嘉,价,驾,嫁,封,贾,稼,架,夹,钾
轴	奏,州,宙,昼,洲,走,皱,骤,周
浆	碱,蒋,讲,匠,简,见,减,尖,箭,键,降,姜,剪,渐,奖,剑,件,健,建,江,疆,检,坚,将,兼,监,肩,鉴,间,艰,舰,僵,践,奸,歼
林	禁,淋,龄,铃,另,您,栖,磷,材,村,邻,陵,灵,玲,框,梦,零,临,领,令,楚,凌,木,岭
橡	享,项,宪,显,乡,象,献,鲜,线,香,县,贤,想,现,翔,祥,箱,掀,相,腺,弦,仙,嫌,响,详,险,限,先,纤,陷,像,湘,向,闲
担	氮,胆,坦,单,弹,丹,党,但,当,旦,诞,荡,档,淡,挡,蛋
亭	停,艇,庭,听,厅,廷,挺
希	晰,戏,袭,析,悉,稀,习,吸,席,西,嘻,锡,细,隙,夕,息,溪,牺,系,惜,洗,喜,媳
填	天,慎,甜,田,真,添
为	畏,慰,委,胃,惟,威,味,围,危,伟,未,位,伪,谓,尾,卫,维,纬,微,魏,喂,唯,违
烦	凡,顺,范,泛,犯,妨,饭,房,寒,反,须,防,汉,仿,纺,页,方,罕,贩,函,番,繁,顽,领,返,翻,喊,涵,韩,放,芳,含,访,旱,汗
腺	享,项,宪,显,乡,象,献,鲜,线,香,县,贤,想,现,翔,祥,箱,掀,橡,相,弦,仙,嫌,响,详,险,限,先,纤,陷,像,湘,向,闲
贯	广,馆,惯,灌,宽,官,罐,观,冠,管,关,光,款
抖	兜,料,斗,豆,科,都
檀	坦,滩,躺,谈,倘,堂,碳,糖,炭,探,贪,坛,塘,汤,唐,趟,叹,摊
剃	体,踢,替,题,梯,提
脉	迈,卖,泳,埋,麦,永,买
唱	阐,苍,藏,缠,肠,厂,尝,偿,昌,仓,场,畅,倡,舱,常,禅,颤,产
搏	博,剥,铺,伯,玻,拨,勃,脖,播,傅,波,辅,驳,缚,捕,薄,膊,甫,卜
滚	昆,困,棍
钉	顶,打,丁,叮,盯,定,订
僵	碱,蒋,讲,匠,简,见,减,尖,箭,键,降,姜,剪,渐,奖,剑,件,健,建,江,疆,检,坚,将,兼,监,肩,鉴,间,艰,舰,践,奸,歼,浆
选	悬,旋,玄,宣
创	川,穿,船,闯,床,串,窗,传,喘
簧	荒,缓,皇,惶,幻,煌,环,欢,黄,患,换,晃,慌,唤
屉	体,踢,替,题,泄,世,梯,蝶,提
虎	抚,扶,忽,副,服,湖,富,糊,虑,乎,赋,复,夫,傅,妇,覆,幅,肤,呼,父,佛,辅,伏,付,胡,符,户,互,弗,腹,赴,咐,缚,浮,府,福,护,腐,辐,负,虚,甫,附
宜	阻,异,逸,役,医,抑,毅,义,一,益,议,疑,亦,乙,姨,蚁,椅,移,译,疫,谊,且,亿,已,组,衣,依,遗,矣,易,仪,以,艺,伊,意,忆,翼
巡	训,讯,旬,寻,迅,询,逊,循
秆	杠,看,干,港,感,甘,堪,肝,赶,坎,敢,刊,岗,刚,纲,杆,砍,钢
橘	巨,距,惧,拒,聚,俱,举,居,据,剧,菊,局,矩,拘,句,具
梅	没,美,妹,海,悔,枚,煤,每,霉,眉,媒
下	夏,吓,霞,峡,狭,瞎,辖
浏	柳,纽,流,瘤,硫,刘,牛,留,溜,扭,六
抓	瓜,孤
梧	物,吴,五,语,乌,雾,舞,屋,无,务,污,悟,午,伍,呜,武,吾,误
瘟	温,吻,翁,文,纹,稳,问,闻
韧	忍,仁,任,认,仍,扔,人
奢	社,涉,设,色,舍,摄,蛇,射,舌
象	享,项,宪,显,乡,献,鲜,线,香,县,贤,想,现,翔,祥,箱,掀,橡,相,腺,弦,仙,嫌,响,详,险,限,先,纤,陷,像,湘,向,闲
嗽	收,搜,瘦,售,兽,受,守,首,寿,手,授
嫂	稍,扫,梢,少,绍,哨,烧
松	宋,耸,送,颂,讼
珍	诊,争,整,症,振,政,怎,挣,侦,证,睁,镇,阵,郑,趁,真,针,蒸,震,贞,正,征
碑	贝,脾,杯,牌,卑,北,背,悲,备,被,辈,倍
赠	争,症,政,怎,挣,证,睁,增,郑,僧,蒸,曾,正,征,整
混	婚,浑,魂,昏
组	阻,柱,煮,驻,租,贮,嘱,主,祝,助,筑,珠,宜,足,住,竹,铸,逐,谊,且,祖,诸,猪,朱,株,族,注
灶	招,遭,造,罩,爪,找,早,兆,藻,召,照,燥,糟,赵
渤	玻,拨,勃,脖,博,播,膊,波,剥,驳,搏,伯,卜
初	础,储,粗,出,楚,促,畜,触,厨,处,除
吝	淋,龄,铃,另,您,磷,邻,陵,灵,玲,林,零,临,领,令,凌,岭
漱	诉,疏,束,数,蔬,淑,署,树,叔,宿,枢,肃,输,术,属,抒,俗,素,书,鼠,熟,舒,速,苏,塑,述,竖,殊
惭	阐,苍,藏,缠,惨,参,残,仓,蚕,禅,颤,舱,餐,产
阶	借,界,介,截,街,价,姐,皆,劫,捷,戒,届,杰,接,洁,竭,节,结,解,揭
汪	万,往,网,湾,忘,亡,旺,完,玩,顽,望,碗,挽,晚,妄,王,弯
荧	鹰,英,映,姻,吟,赢,影,因,迎,殷,隐,盈,应,印,阴,引,硬,营,颖,婴,音,饮,银
傲	奥,澳,凹
戳	错,措
龟	规,跪,鬼,愧,桂,贵,硅,轨,亏,柜,归,溃
淑	诉,疏,束,数,蔬,署,树,叔,宿,枢,肃,输,术,属,抒,俗,素,书,鼠,熟,舒,速,苏,塑,督,述,竖,殊
改	概,慨,钙,盖,溉,该,开,凯
叶	业,野,爷,夜,冶,也,液,页
悟	物,吴,五,语,乌,雾,舞,屋,无,务,污,午,伍,呜,武,吾,误
淋	龄,铃,另,您,磷,邻,陵,灵,玲,林,零,临,领,令,凌,岭
踪	忠,仲,纵,终,众,重,总,崇,宗,种,综,钟,衷,中,肿
条	跳,挑
姐	借,界,介,截,街,皆,劫,捷,戒,届,杰,接,洁,竭,阶,节,结,解,揭
宽	贯,馆,况,惯,灌,狂,框,官,矿,管,罐,观,冠,关,款
多	躲,够,夺,朵,移
迄	汽,期,岂,骑,凄,栖,棋,气,奇,齐,旗,起,其,弃,歧,器,企,漆,戚,七,契,启,妻,欺
蛀	阻,柱,煮,驻,租,贮,嘱,主,祝,助,筑,珠,足,住,竹,铸,逐,组,祖,诸,猪,朱,株,族,注
钢	杠,干,港,康,感,甘,肝,赶,敢,岗,刚,纲,抗,杆,炕
拉	钠,立,粒,辣,娜,蜡,拿,站,哪,啦,那,呐,纳,腊
亥	海,刻,害,核,咳,该,还,孩
掰	摆,拜,白,柏,败,百
茵	鹰,英,映,姻,吟,赢,影,因,迎,殷,隐,盈,应,印,阴,引,硬,营,颖,婴,音,饮,银
饵	职,耳,而,尔,儿,联,耸,耻,二
绸	凑,仇,愁,调,筹,雕,臭,丑,抽,瞅,酬,畴,周
邻	淋,龄,冷,铃,另,您,磷,陵,灵,玲,林,零,临,怜,领,令,凌,岭
稠	凑,仇,愁,调,筹,雕,臭,丑,抽,瞅,酬,畴,周
讹	恶,鹅,鄂,俄,饿,额
据	巨,距,惧,拒,聚,俱,举,居,剧,菊,局,矩,拘,句,具
浓	农,拢,笼,弄,龙,隆,垄
窥	规,跪,鬼,愧,桂,贵,硅,轨,亏,龟,柜,归,溃
缔	底,帝,弟,递,低,抵,蒂,第,滴,迪,堤,敌
罐	广,贯,馆,惯,灌,宽,官,观,冠,管,关,光,款
憔	侨,乔,悄,敲,巧,桥,瞧
赣	杠,看,干,港,感,甘,堪,肝,赶,坎,敢,刊,岗,刚,纲,杆,砍,钢
壁	闭,笔,比,彼,逼,毕,辟,蔽,鼻,碧,必,币,弊,避,臂
民	命,鸣,明,名,敏
惧	巨,距,拒,聚,俱,举,居,据,剧,菊,局,矩,拘,句,具
烈	劣,裂,猎,捏,例,咧,列
旷	广,况,狂,框,矿,宽,光,款
蟹	鞋,写,些,协,卸,斜,谐,携,械,歇,泄,胁,邪,谢
工	功,宫,控,巩,孔,贡,弓,供,空,共,公,攻,恐,恭
肘	奏,州,宙,昼,洲,走,轴,皱,骤,周
髓	虽,税,碎,岁,睡,遂,随,水
斯	市,实,司,寺,尸,四,使,拾,室,期,适,食,世,私,是,施,逝,势,死,识,师,石,试,诗,始,释,蚀,撕,十,湿,思,其,旗,式,似,士,示,氏,丝,史,事,饲,视,驶,时,饰,失,欺
蹦	奔,笨,本
添	天,甜,填,田
愈	与,裕,玉,育,愚,誉,语,豫,遇,雨,宇,愉,喻,于,输,渔,预,余,予,欲,寓,域,郁,狱,娱,羽,舆,鱼,御,偷,浴
媳	晰,戏,袭,析,悉,稀,习,吸,希,席,西,嘻,锡,细,隙,夕,息,溪,牺,系,惜,洗,喜
柔	楼,肉,漏
绎	异,逸,役,医,抑,毅,义,一,益,议,疑,亦,乙,姨,宜,蚁,椅,泽,移,译,疫,谊,亿,已,衣,依,遗,矣,易,择,仪,以,艺,伊,意,忆,翼
楚	禁,促,畜,触,除,粗,储,初,出,梦,林,厨,处,础
话	划,哗,花,画,滑,化,华
采	彩,才,菜,材,财,柴,裁,蔡,猜,拆
哈	答,罚,给,塔,伐,搭,阀,合,拾,乏,恰,法,发
奖	碱,蒋,讲,匠,简,见,减,尖,箭,键,降,姜,剪,渐,剑,件,健,建,江,疆,检,坚,将,兼,监,肩,鉴,间,艰,舰,僵,践,奸,歼,浆
嘹	辽,了,疗,鸟,料,僚,尿,聊
洲	奏,州,宙,昼,走,轴,皱,骤,周
莽	忙,蛮,漫,茫,慢,曼,盲,满
穗	髓,虽,税,碎,岁,睡,遂,随,水
桂	规,跪,鬼,挂,崖,娃,愧,贵,蛙,硅,轨,亏,封,佳,龟,柜,归,溃
济	基,挤,集,鸡,寂,脊,际,机,既,疾,祭,技,及,辑,吉,齐,迹,级,急,极,积,饥,即,几,击,己,绩,肌,激,忌,计,季,继,寄,籍,剂,记,纪
卉	绘,辉,慧,灰,惠,会,恢,汇,挥,悔,毁,徽,回
五	物,吴,乌,雾,舞,屋,无,务,污,悟,午,伍,呜,武,吾,误
驾	夹,架,家,嫁,佳,钾,甲,假,加,嘉,贾,稼,价
稽	基,挤,集,济,鸡,寂,脊,际,机,既,疾,祭,技,及,辑,吉,迹,级,急,极,积,饥,即,几,击,己,绩,肌,激,忌,计,季,继,寄,籍,剂,记,纪
贤	享,项,宪,显,乡,象,献,鲜,线,香,县,想,现,翔,祥,箱,掀,橡,相,腺,弦,仙,嫌,响,详,险,限,先,纤,陷,像,湘,向,闲
把	爸,拔,八,坝,叭,吧,霸,罢,巴
龙	农,绒,溶,熔,容,笼,浓,融,隆,荣,拢,垄,弄,庞
驮	马,托,拖,驱,驰,吗,妈,驼,脱,妥,骂
踱	躲,多,夺,朵
秧	焰,氧,映,阳,厌,严,言,养,验,颜,洋,央,沿,样,宴,燕,咽,扬,盐,研,眼,炎,艳,烟,延,演,杨,掩,衍,仰,羊,岩
它	她,塔,拓,他,踏
乌	物,吴,五,雾,舞,屋,无,务,污,悟,午,伍,呜,武,吾,误
豆	兜,斗,抖,都
呈	尘,称,程,沉,惩,城,层,诚,衬,臣,承,趁,曾,陈,成,晨,撑,乘
箭	碱,蒋,讲,匠,简,见,减,尖,键,降,姜,剪,渐,奖,剑,件,健,建,江,疆,检,坚,将,兼,监,肩,鉴,间,艰,舰,僵,践,奸,歼,浆
旭	许,序,叙,续,蓄,须,需,徐,虚,吁,绪
邪	鞋,写,些,协,卸,斜,谐,携,械,歇,泄,胁,谢
香	享,项,宪,显,乡,象,献,鲜,线,县,贤,想,现,翔,祥,箱,掀,橡,相,腺,弦,仙,嫌,响,详,险,限,先,纤,陷,像,湘,向,闲
柴	彩,才,些,采,菜,材,财,裁,蔡,猜,此,紫,拆
扩	括,国,过,郭,锅,裹,果,阔
惠	绘,辉,慧,灰,会,恢,汇,挥,悔,毁,徽,回
帅	甩,摔,衰,师
匆	从,聪,冲,崇,充,丛,虫
铁	贴
蜘	字,执,肢,滞,址,姿,致,稚,旨,志,直,滋,制,脂,织,支,汁,知,纸,指,资,兹,自,职,止,质,紫,芝,值,智,之,置,秩,治,子,至,殖,植,只,枝
沁	轻,庆,琴,侵,晴,请,倾,清,氢,亲,青,情,勤,秦
坑	垦,耕,肯,抗,更,炕,恳
万	汪,往,网,湾,忘,亡,旺,完,玩,顽,望,碗,挽,晚,妄,王,弯
堆	准,维,队,住,推,对
预	与,裕,玉,育,愚,誉,语,豫,遇,雨,宇,愉,喻,于,愈,渔,余,予,欲,寓,域,郁,狱,娱,羽,舆,鱼,御,浴
帝	底,弟,递,低,抵,蒂,第,滴,迪,堤,敌
荣	绒,溶,熔,拢,容,笼,融,龙,隆,垄
桔	巨,距,惧,拒,聚,俱,吉,举,居,据,剧,菊,局,矩,拘,洁,句,结,具
轮	论,润,伦
少	沙,稍,扫,纱,梢,嫂,抄,绍,哨,烧,妙
评	频,苹,品,凭,平,拼,屏,瓶,萍,贫
踩	彩,才,采,菜,材,财,柴,裁,蔡,猜,拆
境	禁,净,静,惊,金,京,敬,近,精,劲,锦,筋,镜,津,晋,景,竟,浸,尽,巾,经,井,茎,警,颈,竞,进,仅,睛,晶,紧,谨,今,径,斤
怖	不,布,步,补,捕,部
蕾	泪,类,勒,雷,内,累
皱	披,州,彼,轴,走,骤,玻,波,昼,被,坡,奏,皮,疲,宙,破,洲,周
割	葛,格,隔,课,个,歌,棵,哥,可,革,胳,壳,阁,克,各,科,渴,客,鸽,颗,刻,戈
趟	坦,越,滩,躺,走,谈,倘,堂,碳,糖,炭,探,趣,起,贪,坛,塘,徒,趋,汤,超,唐,叹,摊,尚
瓢	票,飘,漂
槐	怀,鬼,魏,愧,魂,坏,淮
逸	异,役,医,抑,毅,义,一,益,议,疑,亦,乙,姨,宜,蚁,椅,移,勉,译,疫,免,谊,亿,已,衣,依,遗,矣,挽,晚,易,仪,以,艺,伊,意,忆,翼
熄	晰,戏,袭,析,悉,稀,习,吸,希,席,西,嘻,锡,细,隙,夕,息,溪,牺,系,惜,洗,喜,媳
晕	辉,孕,允,运,匀,浑,军,挥,云,蕴,韵
体	本,踢,替,题,笨,梯,提
滋	字,执,肢,滞,址,姿,致,稚,旨,志,磁,直,制,脂,织,支,汁,知,纸,指,资,兹,自,职,止,质,紫,芝,值,智,之,置,慈,秩,治,子,至,殖,植,只,枝
碘	奠,垫,典,淀,电,殿,店,点,颠
剪	碱,蒋,讲,匠,简,见,减,尖,箭,键,降,姜,渐,奖,剑,件,健,建,江,疆,检,坚,将,兼,监,肩,鉴,间,艰,舰,僵,践,奸,歼,浆
镑	榜,斑,板,邦,膀,半,傍,伴,帮,班,棒,搬,扮,办,版,颁,般
美	没,妹,梅,枚,煤,每,霉,眉,媒
巍	畏,慰,委,胃,惟,威,味,围,危,伟,未,为,位,伪,谓,尾,卫,维,纬,微,魏,喂,唯,违
舍	社,涉,设,色,摄,蛇,射,舌
巫	物,吴,五,乌,雾,舞,屋,无,务,污,悟,午,伍,呜,武,吾,误
憨	凡,含,范,杭,泛,犯,饭,寒,反,汉,航,贩,罕,烦,番,繁,返,翻,喊,涵,韩,函,旱,汗
森	慎,身,肾,审,申,甚,渗,神,婶,伸,深,沈,僧,什
翘	敲,瞧,桥,翔,巧,乔,悄,羽,侨,翻,翅
谴	前,千,强,潜,迁,钱,歉,谦,遣,墙,欠,腔,签,抢,浅,铅,牵,枪
罢	爸,拔,八,坝,叭,吧,霸,把,巴
统	筒,痛,童,桶,通,铜,同
属	诉,疏,束,数,蔬,淑,署,树,叔,宿,枢,肃,输,术,抒,俗,素,书,鼠,熟,舒,速,苏,塑,述,竖,殊
谭	坦,滩,躺,谈,倘,堂,碳,糖,炭,探,贪,坛,塘,汤,唐,趟,叹,摊
陶	涛,萄,桃,讨,淘,套,逃,掏
锦	禁,净,静,惊,金,京,敬,近,精,劲,筋,镜,津,晋,境,景,竟,浸,尽,巾,经,井,棉,茎,警,颈,绵,竞,进,仅,睛,晶,紧,谨,今,径,斤
午	物,吴,五,乌,雾,舞,屋,无,务,污,悟,伍,呜,武,吾,误
戒	借,界,介,截,街,姐,皆,劫,捷,届,杰,接,洁,竭,阶,节,结,解,揭
还	海,害,咳,孩
财	才,账,贫,采,材,柴,裁,责,货,贪,蔡,猜,拆,彩,贝,菜,贺,负
略	掠
很	狠,份,衡,恒,氛,芬,粉,粪,横,奋,恨,愤,哼,分,坟,纷,痕
运	孕,允,匀,晕,动,云,蕴,韵
铜	筒,痛,童,链,桶,钱,金,通,统,键,针,同
忧	游,友,优,由,又,邮,犹,油,幽,悠,右,有,诱,幼,尤
抵	底,帝,弟,递,低,蒂,第,滴,纸,迪,堤,氏,敌
炬	巨,距,惧,拒,聚,俱,举,居,据,剧,菊,局,矩,拘,句,具
毙	闭,笔,比,彼,逼,毕,壁,蔽,鼻,碧,必,币,弊,避,臂
蚌	榜,斑,板,邦,膀,半,傍,伴,帮,班,棒,搬,扮,办,版,颁,般
逊	训,讯,旬,寻,迅,询,循,巡
厚	否,侯,猴,候,后,喉
湘	享,项,霜,宪,显,乡,象,献,鲜,线,香,县,贤,想,现,翔,祥,箱,掀,橡,相,腺,弦,仙,嫌,响,详,险,限,先,纤,陷,像,向,闲
贫	账,拼,瓶,责,货,品,贪,凭,财,屏,评,苹,贝,平,贺,负,萍,频
碰	棚,膨,朋,喷,捧,彭,盆,蓬
伤	上,衫,赏,珊,陕,商,丧,善,闪,山,嗓,扇,桑,尚
范	凡,泛,犯,妨,饭,房,寒,反,防,汉,仿,纺,方,罕,贩,函,烦,番,繁,返,翻,喊,涵,韩,放,芳,含,访,旱,汗
糖	坦,滩,躺,谈,倘,堂,碳,炭,探,贪,坛,塘,汤,唐,趟,叹,摊
隔	葛,格,课,融,个,歌,棵,哥,可,革,胳,壳,阁,克,各,科,割,渴,客,鸽,颗,刻,戈
浦	扑,铺,葡,仆,朴,谱,普
耐	奈,赖,莱,来,乃,奶
拾	市,实,司,寺,尸,四,使,室,合,适,哈,食,世,私,答,是,施,逝,势,死,识,师,石,试,诗,始,释,蚀,斯,撕,十,湿,思,搭,式,似,士,示,氏,丝,给,塔,史,事,饲,视,驶,时,饰,恰,失
慢	忙,蛮,漫,茫,曼,盲,满
飞	菲,黑,匪,肥,肺,非,嘿,废,费,沸
泊	怕,陌,婆,迫,白,破,拍,伯,柏,帕,泼,颇,坡
氧	焰,阳,厌,严,言,养,验,颜,洋,央,沿,样,宴,燕,咽,秧,扬,盐,研,眼,炎,艳,烟,延,演,杨,掩,衍,仰,羊,岩
缝	冯,风,疯,蜂,份,衡,恒,氛,锋,芬,峰,粉,封,凤,奉,丰,粪,蓬,横,奋,哼,逢,分,坟,纷,愤
苗	描,庙,猫,秒,妙
猬	畏,慰,委,胃,惟,威,味,围,危,伟,未,为,位,伪,谓,尾,卫,维,纬,微,魏,喂,唯,违
墩	敦,顿,蹲,吨,盾
汹	胸,兄,熊,凶,雄
血	穴,学,雪,削
逗	兜,斗,抖,豆,都
筝	诊,争,整,珍,症,振,政,侦,挣,证,睁,镇,增,阵,郑,真,针,蒸,震,贞,正,征
钥	姚,咬,摇,腰,邀,要,耀,药,遥
趴	怕,爬,帕
同	筒,痛,童,桶,通,统,铜
处	础,储,粗,初,出,楚,促,畜,触,厨,除
涩	社,涉,设,色,舍,摄,蛇,射,舌
茶	叉,插,擦,察,差,查
橱	础,储,粗,初,出,楚,促,畜,触,厨,处,除
贡	功,宫,控,巩,工,孔,弓,供,空,共,公,攻,恐,恭
彬	饼,兵,冰,滨,并,丙,宾,病
蕴	孕,允,运,匀,晕,云,韵
云	孕,允,运,匀,晕,动,蕴,韵
搬	榜,斑,板,邦,膀,半,傍,伴,帮,班,棒,扮,办,版,颁,般
耻	词,次,池,齿,址,瓷,刺,磁,持,驰,此,耸,辞,职,斥,止,联,尺,耳,迟,慈,吃,翅,雌,赤
汽	期,岂,骑,凄,栖,棋,气,奇,齐,旗,起,其,弃,歧,器,企,漆,戚,七,契,启,妻,欺
硕	所,说,锁,索,缩
泻	鞋,写,些,协,卸,斜,谐,携,械,歇,泄,胁,邪,谢
却	缺,雀,确
豌	万,汪,往,网,湾,忘,亡,旺,完,玩,顽,望,碗,挽,晚,妄,王,弯
蹬	灯,瞪,凳,登,等,邓
佐	卓,作,桌,捉,做,左,昨,座,坐
寅	鹰,英,映,姻,吟,赢,影,因,迎,殷,隐,盈,应,印,阴,引,硬,营,颖,婴,音,饮,银
们	蒙,萌,猛,门,梦,盟,闷,孟
肚	渡,杜,督,赌,独,毒,堵,读,度
澎	棚,碰,膨,朋,喷,捧,彭,盆,蓬
网	万,汪,往,湾,忘,亡,旺,完,玩,顽,望,碗,挽,晚,妄,王,弯
筐	广,况,狂,框,矿,宽,光,款
窃	切,且
时	市,过,实,司,寺,尸,四,使,拾,室,适,食,世,私,是,村,施,逝,势,衬,付,死,识,师,石,试,诗,始,释,蚀,斯,撕,十,湿,思,寸,守,式,似,讨,士,示,氏,丝,对,史,事,饲,视,驶,饰,失
住	阻,准,柱,煮,驻,租,贮,嘱,主,祝,往,助,筑,珠,堆,足,推,竹,铸,逐,组,祖,维,诸,猪,朱,株,族,注
苦	姑,骨,股,故,固,酷,鼓,雇,咕,库,孤,古,枯,谷,哭,裤,顾,估
妃	菲,黑,匪,肥,肺,非,嘿,废,记,己,费,飞,沸,纪
匹	披,譬,皮,辟,疲,屁,脾,批
沧	苍,藏,惨,参,肠,厂,唱,尝,偿,残,昌,仓,蚕,场,畅,倡,舱,常,白,餐,抢,枪
琴	轻,斑,庆,侵,晴,请,倾,清,班,氢,亲,青,王,狂,情,勤,秦
袱	抚,扶,忽,副,服,湖,富,糊,乎,赋,复,夫,傅,妇,覆,幅,肤,呼,父,佛,辅,伏,付,胡,符,户,互,弗,腹,赴,咐,缚,浮,府,福,护,虎,腐,辐,负,甫,附
队	堆,对
休	修,羞,绣,袖,秀,朽
舵	躲,多,夺,朵
备	贝,杯,卑,北,背,悲,碑,被,辈,倍
竖	诉,疏,束,数,蔬,淑,署,树,叔,宿,枢,肃,输,术,属,抒,俗,素,书,鼠,熟,舒,速,苏,塑,述,殊
宏	鸿,轰,哄,洪,红
舶	玻,拨,勃,脖,博,播,膊,波,剥,驳,搏,伯,卜
锌	醒,行,杏,兴,新,信,幸,欣,性,型,辛,心,姓,形,星,刑
焕	荒,缓,皇,惶,幻,煌,环,欢,黄,患,换,晃,慌,唤
倍	贝,杯,卑,北,背,悲,碑,备,被,辈,陪,部
鹉	物,吴,五,乌,雾,舞,屋,无,务,污,悟,午,伍,呜,武,吾,误
岳	曰,越,约,悦,跃,月,阅
沼	招,遭,造,罩,爪,灶,找,早,兆,藻,召,照,燥,糟,赵
拣	碱,蒋,讲,匠,简,见,减,尖,箭,键,降,姜,剪,渐,奖,剑,件,健,建,江,疆,检,坚,将,兼,监,肩,鉴,间,艰,舰,僵,践,奸,歼,浆
投	股,设,没,透,偷,役,头,般
狗	扣,钩,够,口,构,沟,购,勾
掐	陷,恰
等	灯,瞪,凳,待,寺,登,特,邓,诗,持
狮	市,实,司,寺,尸,四,使,拾,室,适,食,世,私,是,施,逝,势,死,识,师,石,试,诗,始,释,蚀,斯,撕,十,湿,思,式,似,士,示,氏,丝,史,事,饲,视,驶,时,饰,失
违	畏,慰,委,胃,惟,威,味,围,危,伟,未,为,位,伪,谓,尾,卫,维,纬,微,魏,喂,唯
蚪	兜,斗,抖,豆,都
听	停,艇,亭,庭,厅,廷,挺
拼	频,苹,品,饼,凭,平,屏,并,瓶,萍,贫,评
凿	招,遭,造,罩,爪,灶,找,早,兆,藻,召,照,燥,糟,赵
以	异,逸,役,医,抑,毅,义,一,益,议,疑,亦,乙,姨,宜,蚁,椅,移,译,疫,谊,亿,已,衣,依,遗,矣,易,仪,艺,伊,意,忆,翼
徒	涂,超,趣,越,起,趟,土,途,突,走,屠,图,兔,趋,吐
渊	源,员,元,愿,远,原,怨,圆,援,冤,园,缘,袁,院
镶	享,项,宪,显,乡,象,献,鲜,线,香,县,贤,想,现,翔,祥,箱,掀,橡,相,腺,弦,仙,嫌,响,详,险,限,先,纤,陷,像,湘,向,闲
更	坑,跟,耕,硬,便,根
恕	努,诉,疏,怒,束,数,蔬,淑,署,树,叔,宿,枢,肃,输,术,属,抒,俗,素,书,鼠,熟,奴,舒,速,苏,塑,述,竖,殊
承	尘,称,程,沉,惩,城,层,诚,衬,臣,呈,趁,曾,陈,成,晨,撑,乘
健	碱,蒋,讲,匠,简,见,减,尖,箭,键,降,姜,剪,渐,奖,剑,件,建,江,疆,检,坚,将,兼,监,肩,鉴,间,艰,舰,僵,践,奸,歼,浆
致	字,执,肢,滞,址,姿,稚,旨,志,到,直,滋,制,脂,织,支,汁,知,纸,指,资,兹,自,职,止,质,紫,芝,值,智,之,置,倒,秩,治,子,至,殖,植,只,枝
池	词,次,齿,瓷,刺,磁,持,驰,此,辞,耻,斥,尺,迟,慈,吃,翅,雌,赤
凯	概,慨,改,钙,饥,盖,几,肌,溉,该,开
盈	鹰,英,映,姻,吟,赢,影,因,迎,殷,隐,应,印,阴,引,硬,营,颖,婴,音,饮,银
真	诊,争,整,珍,症,振,政,怎,挣,侦,证,睁,镇,填,阵,慎,郑,针,蒸,震,贞,正,征
瘩	答,打,搭,达,大
盛	生,审,渗,婶,伸,城,升,身,绳,肾,诚,省,什,慎,圣,声,申,牲,神,剩,深,沈,僧,胜,甚,成
脓	农,拢,笼,弄,浓,龙,隆,垄
觅	迷,秘,蜜,弥,米,密,泌
元	源,员,愿,远,原,渊,怨,圆,援,完,玩,冤,园,缘,袁,院
羽	与,裕,玉,育,愚,誉,语,豫,遇,雨,宇,愉,喻,翔,于,愈,渔,预,余,予,欲,寓,域,郁,狱,娱,舆,鱼,御,翻,浴,翅
颤	阐,缠,惨,参,肠,厂,唱,尝,偿,残,昌,蚕,场,畅,倡,常,禅,餐,产
微	畏,慰,委,胃,惟,威,味,围,危,伟,未,为,位,伪,谓,尾,卫,维,纬,魏,喂,唯,违
夺	躲,多,朵
舆	与,裕,玉,育,愚,誉,语,豫,遇,雨,宇,愉,喻,于,愈,渔,预,余,予,欲,寓,域,郁,狱,娱,羽,鱼,御,浴
手	收,搜,瘦,售,兽,受,守,首,寿,授
达	答,打,搭,大
己	基,挤,集,济,鸡,寂,脊,际,机,既,疾,祭,技,及,辑,吉,迹,级,急,极,积,饥,即,几,击,绩,肌,激,忌,计,季,继,寄,籍,剂,记,纪
铐	高,搞,靠,告,考,稿
嘛	马,蚂,吗,麻,妈,码,玛,骂
靴	穴,学,血,雪,削
捅	筒,痛,童,桶,涌,通,统,铜,同
呼	抚,扶,忽,副,服,湖,富,糊,乎,赋,复,夫,傅,妇,覆,幅,肤,父,佛,辅,伏,付,胡,符,户,互,弗,腹,赴,咐,缚,浮,府,福,护,虎,腐,辐,负,甫,附
轩	杆,悬,干,选,旋,玄,宣
敌	底,帝,弟,递,低,抵,蒂,第,滴,迪,堤
任	忍,仁,认,仍,扔,人
善	上,衫,赏,珊,陕,三,商,散,伤,闪,山,扇,尚
邀	姚,咬,摇,腰,要,耀,药,遥
戈	葛,格,隔,课,个,歌,棵,哥,可,革,胳,壳,阁,克,各,科,割,渴,客,鸽,颗,刻
雏	础,储,粗,初,出,楚,促,畜,触,厨,处,除
书	诉,疏,束,数,蔬,淑,署,树,叔,宿,枢,肃,输,术,属,抒,俗,素,鼠,熟,舒,速,苏,塑,述,竖,殊
犬	天,权,拳,圈,全,大,劝,泉,夫,券
秩	字,执,肢,滞,址,姿,致,稚,旨,志,直,滋,制,脂,织,支,汁,知,纸,指,资,兹,自,职,止,质,紫,芝,值,智,之,置,治,子,至,殖,植,只,枝
沥	逆,黎,厉,梨,理,李,利,立,离,礼,吏,厘,莉,历,哩,隶,你,丽,拟,尼,励,力,里,泥,日,例,粒,璃
聚	巨,距,惧,拒,俱,举,居,据,剧,菊,局,矩,拘,句,具
衫	上,赏,珊,陕,三,商,散,善,伤,闪,山,扇,尚
往	柱,驻,万,汪,主,网,湾,忘,住,亡,旺,完,玩,顽,望,碗,挽,晚,妄,王,弯,注
刚	杠,干,港,康,感,甘,肝,赶,敢,岗,纲,抗,杆,钢,炕
最	嘴,罪,醉,追
瑰	规,跪,鬼,愧,桂,贵,硅,轨,亏,龟,魂,柜,归,魏,溃
涡	窝,祸,锅,我,卧,握
憾	凡,含,范,杭,泛,犯,饭,寒,反,汉,航,贩,罕,烦,番,繁,返,翻,喊,涵,韩,函,旱,汗
挑	跳,桃,兆,条,逃
候	否,侯,厚,猴,后,喉
乡	享,项,宪,显,象,献,鲜,线,香,县,贤,想,现,翔,祥,箱,掀,橡,相,腺,弦,仙,嫌,响,详,险,限,先,纤,陷,像,湘,向,闲
忆	异,逸,役,医,抑,毅,义,一,益,议,疑,亦,乙,姨,宜,蚁,椅,移,译,疫,谊,亿,已,衣,依,遗,矣,易,仪,以,艺,伊,意,翼
超	越,吵,走,巢,朝,抄,槽,草,潮,趣,起,徒,趋,操,趟,曹
灯	瞪,凳,登,等,邓
弹	氮,胆,单,丹,党,但,当,旦,诞,荡,档,淡,挡,蛋,担
猾	划,话,哗,花,画,滑,化,骨,华
蔗	这,择,哲,浙,著,折,者,遮,责,则,泽,着
息	晰,戏,袭,析,悉,稀,习,吸,希,席,西,嘻,锡,细,隙,夕,溪,牺,系,惜,洗,喜,媳
粮	梁,凉,谅,娘,良,链,辆,恋,亮,连,练,炼,联,两,怜,廉,莲,量,帘,脸
室	市,实,司,寺,尸,四,使,拾,适,食,世,私,是,施,逝,势,死,识,师,石,试,诗,始,释,蚀,斯,撕,十,湿,思,式,似,士,示,氏,丝,史,事,饲,视,驶,时,饰,失
子	字,执,肢,滞,址,姿,致,稚,旨,志,直,滋,制,脂,织,支,汁,知,纸,指,资,兹,自,职,止,质,紫,芝,值,智,之,置,秩,治,至,殖,植,只,枝
谅	惊,梁,京,凉,娘,良,链,景,辆,恋,亮,连,练,炼,联,两,怜,廉,粮,掠,莲,量,帘,脸
赡	上,衫,赏,珊,陕,三,商,散,善,伤,闪,山,扇,尚
居	巨,距,惧,拒,聚,俱,举,据,剧,菊,局,矩,拘,句,具
盐	焰,氧,阳,厌,严,言,养,验,颜,猛,洋,央,沿,孟,样,盆,宴,燕,咽,秧,扬,研,眼,炎,艳,烟,延,演,杨,掩,衍,监,仰,盒,羊,岩
形	醒,行,杏,兴,新,信,幸,欣,性,型,辛,心,姓,星,刑,开
胖	判,盼,盘,叛,潘,庞,攀,旁
滑	划,话,哗,花,画,化,骨,华
绒	溶,熔,拢,容,笼,融,龙,隆,荣,垄
耗	豪,浩,好,号,毫
酉	优,犹,幽,酒,醉,游,由,又,悠,忧,有,诱,油,右,邮,幼,配,友,酬,尤
笼	农,绒,溶,熔,容,浓,融,龙,隆,荣,拢,垄,弄,庞
误	物,吴,五,乌,雾,舞,屋,无,务,污,悟,午,伍,呜,娱,武,吾
坷	葛,格,隔,课,个,歌,棵,哥,可,革,胳,壳,阁,克,各,科,割,渴,客,鸽,颗,刻,戈
侧	测,策,彻,车,扯,撤,册,则
空	控,贡,功,宫,巩,工,共,恭,穴,攻,恐,孔,穷,弓,供,公
旅	绿,虑,妨,仿,氯,纺,驴,方,铝,吕,律,女,履,率,防,访
建	碱,蒋,讲,匠,简,见,减,尖,箭,键,降,姜,剪,渐,奖,剑,件,健,江,疆,检,坚,将,兼,监,肩,鉴,间,艰,舰,僵,践,奸,歼,浆
挥	绘,辉,汇,毁,灰,回,慧,惠,恢,军,徽,晕,会,浑,悔
裁	彩,才,采,菜,材,财,柴,蔡,猜,拆
零	淋,龄,铃,另,磷,邻,陵,灵,玲,凝,林,临,领,令,凌,岭,宁
泣	汽,拉,期,岂,骑,凄,立,栖,棋,气,奇,齐,旗,起,其,弃,歧,器,企,漆,戚,七,契,启,粒,妻,欺,站
助	阻,柱,煮,驻,租,贮,嘱,主,祝,筑,珠,足,住,竹,铸,逐,组,祖,诸,猪,朱,株,族,注
浴	与,裕,玉,育,愚,誉,语,豫,遇,雨,宇,愉,喻,于,愈,渔,预,余,俗,予,欲,寓,域,郁,狱,娱,羽,舆,谷,鱼,御
会	绘,辉,慧,灰,惠,恢,汇,挥,悔,毁,徽,回
葡	扑,铺,仆,朴,谱,普
辈	贝,菲,杯,排,匪,非,卑,北,背,悲,碑,备,被,倍
余	与,裕,玉,育,愚,誉,语,豫,遇,雨,宇,除,愉,喻,斜,叙,于,途,愈,渔,预,徐,予,欲,寓,域,郁,狱,娱,羽,舆,涂,鱼,御,浴
艳	焰,氧,阳,厌,严,言,养,验,颜,洋,央,沿,样,宴,燕,咽,秧,扬,盐,研,眼,炎,烟,延,演,杨,掩,衍,仰,羊,岩
纺	凡,范,杭,泛,犯,妨,饭,房,反,仿,航,方,贩,烦,番,繁,旅,返,翻,放,芳,防,访
伍	物,吴,五,乌,雾,舞,屋,无,务,污,悟,午,呜,武,吾,误
质	字,执,肢,滞,址,姿,致,稚,旨,志,直,滋,制,脂,织,支,汁,知,纸,指,资,兹,自,职,止,紫,芝,值,智,之,置,秩,治,子,至,殖,植,只,枝
葫	抚,扶,忽,副,服,湖,富,糊,乎,赋,复,夫,傅,妇,覆,幅,肤,呼,父,佛,辅,伏,付,胡,符,户,互,弗,腹,赴,咐,缚,浮,府,福,护,虎,腐,辐,负,甫,附
科	葛,格,隔,课,个,歌,棵,哥,可,革,胳,壳,阁,料,克,各,割,渴,客,鸽,颗,斗,抖,刻,戈
正	诊,争,整,珍,症,振,惩,政,侦,挣,证,睁,镇,歪,增,阵,郑,真,针,蒸,震,贞,征
纸	底,字,执,肢,滞,址,姿,致,稚,旨,志,直,滋,制,脂,织,低,抵,支,汁,知,指,资,兹,自,职,止,质,紫,芝,值,智,氏,之,置,秩,治,子,至,殖,植,只,枝
杀	沙,纱,萨,刹,洒,啥,撒,厦,砂,傻
族	阻,柱,煮,驻,租,贮,嘱,主,祝,助,筑,珠,足,住,竹,铸,逐,组,祖,诸,猪,朱,株,注
底	帝,弟,递,低,抵,蒂,第,滴,纸,迪,堤,氏,敌
江	碱,蒋,讲,匠,简,见,减,尖,箭,键,降,姜,剪,渐,奖,剑,件,健,建,疆,检,坚,将,兼,监,肩,鉴,间,艰,舰,僵,践,奸,歼,浆
予	与,裕,玉,育,愚,誉,语,豫,遇,雨,宇,愉,喻,于,愈,渔,预,余,欲,寓,域,郁,狱,娱,羽,舆,鱼,御,浴
择	译,这,哲,浙,著,折,者,遮,责,则,泽,着
赎	诉,疏,束,数,蔬,淑,署,树,叔,宿,枢,肃,输,术,属,抒,俗,素,书,鼠,熟,舒,速,苏,塑,述,竖,殊
丹	氮,胆,单,弹,党,但,当,旦,诞,荡,档,淡,挡,蛋,担
原	源,员,元,愿,远,渊,怨,圆,援,冤,园,缘,袁,院
檬	蒙,萌,猛,门,们,梦,盟,闷,孟
那	钠,辣,拉,娜,蜡,拿,哪,啦,呐,纳,腊
笛	底,滴,抽,递,低,抵,由,庙,帝,敌,弟,袖,第,油,邮,迪,堤,蒂
乃	奈,赖,莱,来,奶,耐
逞	尘,称,程,沉,惩,城,层,诚,衬,臣,承,呈,趁,曾,陈,成,晨,撑,乘
闺	规,跪,鬼,愧,桂,贵,硅,轨,亏,龟,柜,归,溃
糙	巢,超,操,朝,抄,曹,槽,吵,草,潮
杜	渡,督,赌,独,毒,堵,读,肚,度
貌	茅,帽,冒,毛,茂,贸,猫,矛
拓	她,它,塔,他,踏
嘻	晰,戏,袭,析,悉,稀,习,吸,希,席,西,锡,细,隙,夕,息,溪,牺,系,惜,洗,喜,媳
讥	基,挤,集,济,鸡,寂,脊,际,机,既,疾,祭,技,及,辑,吉,迹,凯,级,急,极,积,饥,即,几,击,己,绩,肌,激,忌,计,季,继,寄,籍,剂,记,纪
部	不,布,步,陪,补,捕,倍
激	基,挤,集,济,鸡,寂,脊,际,机,既,疾,祭,技,及,辑,吉,迹,级,急,极,积,饥,即,几,击,己,绩,肌,忌,计,季,继,寄,籍,剂,记,纪
番	凡,范,泛,犯,妨,饭,房,寒,反,防,汉,仿,纺,方,罕,贩,函,烦,繁,返,翻,喊,涵,韩,放,芳,含,访,旱,汗
撞	状,壮,赚,童,转,装,砖,庄,专
吁	序,需,宇,绪,许,叙,于,须,徐,蓄,续,虚
酪	老,闹,牢,扰,捞,脑,恼,劳,饶,绕
槽	遭,巢,超,操,朝,抄,曹,糟,吵,草,潮
婪	懒,禁,郎,篮,然,南,烂,难,栏,滥,染,浪,拦,兰,廊,览,梦,林,燃,蓝,楚,男,朗,狼
烙	老,闹,牢,扰,捞,脑,恼,劳,饶,绕
陋	柔,楼,肉,漏
脂	字,执,肢,滞,址,姿,致,稚,旨,志,直,滋,制,织,支,汁,知,纸,指,资,兹,自,职,止,质,紫,芝,值,智,之,置,秩,治,子,至,殖,植,只,枝
司	市,实,寺,尸,四,使,拾,室,适,食,世,私,是,施,逝,势,死,识,师,石,试,诗,始,释,蚀,斯,撕,十,湿,思,式,似,士,示,氏,丝,史,事,饲,视,驶,时,饰,失
彼	披,闭,笔,比,逼,玻,毕,壁,波,蔽,被,鼻,坡,皮,碧,必,皱,币,弊,疲,破,避,臂
载	摘,窄,寨,宰,再,灾,在,宅,债,仔,栽
毯	坦,滩,躺,毛,谈,倘,堂,碳,糖,炭,探,贪,坛,塘,汤,唐,趟,叹,摊,毫
狭	夏,夹,下,吓,霞,峡,瞎,辖
馨	醒,行,杏,兴,新,信,幸,欣,性,型,辛,心,姓,形,星,刑
尊	准,遵
姆	亩,木,牧,墓,幕,慕,穆,目,母
禁	净,静,惊,金,京,敬,近,精,劲,锦,筋,镜,津,晋,境,景,竟,浸,尽,巾,经,井,梦,林,茎,警,颈,竞,进,仅,睛,楚,晶,紧,谨,今,径,斤
茁	卓,作,桌,捉,做,左,昨,座,坐
驴	绿,女,虑,旅,铝,率,履,户,吕,律,炉,房,氯
询	训,讯,旬,寻,迅,逊,循,巡
铺	谱,扑,搏,辅,普,仆,捕,膊,葡,朴,甫
欲	与,裕,玉,育,愚,誉,语,豫,遇,雨,宇,愉,喻,于,愈,渔,预,余,予,寓,域,郁,狱,娱,羽,舆,鱼,御,浴
逝	市,实,司,寺,尸,四,使,拾,室,适,食,世,私,是,施,势,死,识,师,石,试,诗,始,释,蚀,斯,撕,十,湿,思,式,似,士,示,氏,丝,史,事,饲,视,驶,时,饰,失
就	舅,究,旧,久,酒,救,九,纠
侮	物,吴,五,梅,乌,雾,舞,屋,无,务,海,污,悟,霉,午,伍,呜,武,悔,每,吾,误
剥	绿,博,录,伯,玻,拨,勃,脖,播,波,逮,搏,驳,膊,碌,卜
戎	绒,溶,熔,拢,容,笼,融,龙,隆,荣,垄
讶	芽,押,雅,压,哑,鸦,鸭,崖,牙,呀,亚
勒	泪,蕾,类,雷,内,累
主	阻,柱,煮,驻,租,贮,嘱,祝,往,助,筑,珠,足,住,竹,铸,逐,组,祖,诸,猪,朱,株,族,注
饼	兵,冰,滨,并,拼,丙,宾,病
棱	愣,冷,能,仍,扔
生	审,渗,婶,伸,升,身,绳,肾,省,什,慎,性,圣,声,申,牲,神,剩,深,沈,僧,胜,姓,甚,盛,星
捶	摧,吹,垂,脆,锤,催,粹,睡,崔,翠
浸	禁,净,静,惊,金,京,敬,近,精,劲,锦,筋,镜,津,晋,境,景,竟,尽,巾,经,井,茎,警,颈,竞,进,仅,睛,晶,紧,谨,今,径,斤
裳	上,衫,赏,珊,陕,商,丧,善,伤,闪,山,嗓,扇,桑,尚
品	频,苹,凭,平,拼,屏,瓶,萍,贫,评
刁	吊,调,雕,掉
格	葛,隔,课,个,歌,棵,哥,可,革,胳,壳,阁,克,各,科,割,渴,客,鸽,颗,刻,戈
哺	不,膊,布,铺,步,搏,补,辅,捕,甫,部
她	它,塔,拓,他,踏
继	基,挤,集,济,鸡,寂,脊,际,机,迷,既,疾,祭,技,及,辑,米,吉,断,迹,级,急,极,积,饥,即,几,击,己,绩,肌,激,忌,计,季,寄,籍,剂,记,纪
欠	前,千,强,潜,迁,坎,钱,歉,谦,遣,墙,吹,欢,腔,签,抢,浅,饮,铅,牵,枪
骡	弱,落,螺,诺,萝,洛,络,逻,若,累,裸,罗
启	汽,期,岂,骑,凄,栖,棋,气,奇,齐,旗,起,其,弃,歧,器,企,漆,戚,七,契,妻,欺
哆	躲,多,够,夺,朵,移
凡	范,泛,犯,妨,饭,房,寒,反,防,汉,仿,纺,方,罕,贩,函,烦,番,繁,返,翻,喊,涵,韩,放,芳,含,访,旱,汗
亏	规,跪,鬼,愧,桂,贵,硅,轨,龟,柜,归,溃
摔	帅,甩,率,衰
爷	业,叶,野,夜,冶,也,液,页
与	裕,玉,育,愚,誉,语,豫,遇,雨,宇,愉,喻,于,愈,渔,预,余,予,欲,寓,域,郁,狱,娱,羽,舆,鱼,御,浴
辗	展,娘,链,恋,连,练,炼,联,怜,廉,念,莲,年,帘,脸
涂	除,余,斜,土,徒,叙,途,突,屠,图,兔,徐,吐
针	诊,争,整,金,珍,症,振,政,怎,挣,侦,链,证,钱,睁,镇,键,铜,阵,郑,真,蒸,震,贞,正,征
险	享,项,宪,显,乡,象,献,鲜,线,香,县,贤,想,现,验,翔,祥,箱,掀,橡,相,腺,弦,仙,嫌,检,响,详,签,限,先,纤,陷,像,脸,湘,向,闲
帆	凡,范,泛,犯,妨,饭,房,寒,反,防,汉,仿,纺,方,罕,贩,函,烦,番,繁,返,翻,喊,涵,韩,放,芳,含,访,旱,汗
州	奏,宙,昼,洲,走,轴,皱,骤,周
诉	疏,束,数,蔬,淑,署,树,叔,宿,枢,肃,输,术,属,抒,俗,素,书,鼠,熟,舒,速,苏,塑,述,竖,殊
道	盗,倒,岛,稻,导,蹈,刀,到
锋	冯,风,疯,蜂,份,衡,恒,氛,缝,芬,峰,粉,封,凤,奉,丰,粪,蓬,横,奋,哼,逢,分,坟,纷,愤
拙	卓,左,座,桌,作,掘,做,昨,屈,出,捉,坐
榆	与,裕,玉,育,愚,誉,语,豫,遇,雨,宇,愉,喻,于,愈,输,渔,预,余,予,欲,寓,域,郁,狱,娱,羽,舆,鱼,御,偷,浴
军	辉,峻,浑,俊,君,挥,晕,菌,均
丫	芽,押,雅,压,哑,鸦,鸭,崖,牙,呀,亚
储	础,粗,初,出,楚,促,畜,触,厨,处,除
苹	频,品,凭,平,拼,屏,瓶,萍,贫,评
盏	暂,账,展,粘,章,长,占,掌,涨,障,仗,张,咱,战,沾,丈,胀,赞,帐,站
召	招,遭,造,罩,爪,灶,找,早,兆,藻,照,燥,糟,赵
紊	温,吻,翁,文,纹,稳,问,闻
伯	博,怕,剥,玻,拨,勃,脖,播,波,拍,搏,泊,柏,帕,陌,白,驳,膊,卜
镀	渡,杜,督,赌,独,毒,堵,读,肚,度
袋	呆,代,逮,戴,带,待,贷
谈	坦,滩,躺,倘,堂,碳,糖,炭,探,贪,坛,塘,汤,唐,趟,叹,摊
获	货,祸,伙,惑,或,霍,活,火
陕	上,衫,赏,珊,三,商,散,善,伤,闪,山,扇,尚
去	取,屈,趣,驱,渠,躯,区,曲,趋
景	禁,净,静,惊,金,京,敬,凉,近,精,谅,劲,锦,筋,镜,津,晋,境,竟,浸,尽,巾,经,井,茎,警,颈,竞,掠,进,仅,睛,晶,紧,谨,今,径,斤
孤	抓,姑,骨,股,瓜,故,苦,固,酷,鼓,雇,咕,库,古,枯,谷,哭,裤,顾,估
离	逆,黎,厉,梨,理,李,利,立,礼,吏,厘,莉,历,哩,隶,你,丽,拟,尼,励,力,里,泥,日,例,粒,璃
赫	喝,盒,合,何,贺,荷,呵,河,核,和
荆	禁,净,静,惊,金,京,敬,近,精,劲,锦,筋,镜,津,晋,境,景,竟,浸,尽,巾,经,井,茎,警,颈,竞,进,仅,睛,晶,紧,谨,今,径,斤
谨	禁,净,静,惊,金,京,敬,近,精,劲,锦,筋,镜,津,晋,境,景,竟,浸,尽,巾,经,井,茎,警,颈,竞,进,仅,睛,勤,晶,紧,今,径,斤
隧	髓,虽,税,碎,岁,睡,遂,随,水
诺	逻,螺,萝,络,落,裸,洛,罗
远	源,员,元,愿,原,渊,怨,圆,援,完,玩,冤,园,缘,袁,院
纲	杠,干,港,康,感,甘,肝,赶,敢,岗,刚,抗,杆,钢,炕
舟	奏,州,宙,昼,洲,舰,走,轴,皱,骤,航,周
叭	爸,拔,八,坝,吧,霸,罢,把,巴
瘾	鹰,英,映,姻,吟,赢,影,因,迎,殷,隐,盈,应,印,急,阴,引,硬,营,稳,颖,婴,音,饮,银
崩	奔,笨,本
硬	鹰,英,映,姻,吟,赢,影,因,迎,殷,隐,盈,应,印,阴,引,营,便,颖,婴,音,饮,更,银
伟	畏,慰,委,胃,惟,威,味,围,危,韦,未,为,位,伪,谓,尾,卫,维,纬,微,魏,喂,唯,违
罕	凡,含,范,杭,泛,犯,饭,寒,反,汉,航,贩,烦,番,繁,返,翻,喊,涵,韩,函,旱,汗
繁	凡,范,泛,犯,妨,饭,房,寒,反,防,汉,仿,纺,方,罕,贩,函,烦,番,返,翻,喊,涵,韩,放,芳,含,访,旱,汗
铃	淋,龄,冷,另,磷,邻,陵,灵,玲,凝,林,零,临,怜,领,令,凌,岭,宁
熙	晰,戏,袭,析,悉,稀,习,吸,希,席,西,嘻,锡,细,隙,夕,息,溪,牺,系,惜,洗,喜,媳
浑	辉,婚,魂,军,昏,挥,晕,混
诱	优,犹,秀,幽,游,透,由,又,悠,忧,有,绣,油,右,邮,幼,友,尤
搂	柔,楼,数,肉,漏
全	权,拳,圈,劝,泉,券
小	效,萧,硝,销,孝,消,笑,晓,校,肖
靠	高,搞,告,考,稿
奉	冯,风,疯,蜂,份,衡,恒,氛,锋,缝,捧,芬,峰,粉,封,凤,丰,粪,棒,横,奋,哼,逢,分,坟,纷,愤
维	准,畏,慰,委,胃,惟,威,味,围,危,伟,堆,住,推,未,为,位,伪,谓,尾,卫,纬,微,魏,喂,唯,违
疙	葛,格,隔,课,个,歌,棵,哥,可,革,胳,壳,阁,克,各,科,割,渴,客,鸽,颗,刻,戈
蛙	娃,哇,封,佳,桂,崖,挂,挖,瓦
璃	逆,黎,厉,梨,理,李,利,立,离,礼,吏,厘,莉,历,哩,隶,你,丽,拟,尼,励,力,里,泥,日,例,粒
妥	托,拖,女,驼,要,脱
肪	凡,范,杭,泛,犯,妨,饭,房,反,仿,航,纺,方,贩,烦,番,繁,返,翻,放,芳,防,访
玷	奠,垫,贴,淀,电,殿,粘,点,占,店,颠,战,沾,典,站
腰	姚,咬,摇,邀,要,耀,药,遥
层	城,曾,称,诚,程,呈,成,惩,撑,乘,承
茧	碱,蒋,讲,匠,简,见,减,尖,箭,键,降,姜,剪,渐,奖,剑,件,健,建,江,疆,检,坚,将,兼,监,肩,鉴,间,艰,舰,僵,践,奸,歼,浆
契	汽,期,岂,骑,凄,栖,棋,气,奇,齐,旗,起,其,弃,歧,器,企,漆,戚,七,启,妻,欺
鳍	汽,期,鲜,岂,骑,凄,栖,棋,气,奇,齐,旗,起,其,弃,歧,器,企,漆,戚,鱼,七,契,启,妻,欺
颓	退,腿,推
锐	瑞
芦	努,辱,录,怒,炉,儒,如,露,入,奴,陆,路,鲁,乳,碌,卢,鹿
拖	托,驼,脱,妥
剿	胶,骄,郊,焦,角,搅,脚,较,缴,教,交,轿,娇,叫
支	字,执,肢,滞,址,姿,致,稚,旨,志,直,滋,制,脂,织,技,汁,知,纸,指,资,兹,自,职,鼓,止,质,歧,紫,芝,值,智,之,置,秩,治,子,至,殖,植,只,枝
挟	鞋,携,谢,斜,峡,狭,写,些,协,谐,械,歇,邪,夹,卸,泄,胁
兵	饼,冰,滨,并,丙,宾,病
秀	修,羞,绣,袖,透,休,诱,朽
哄	鸿,轰,洪,红,宏,共
稳	急,温,吻,翁,文,隐,纹,问,闻
吕	绿,宫,女,虑,旅,铝,率,履,律,氯,驴
眉	没,美,妹,梅,枚,煤,每,霉,媒
柱	阻,煮,驻,租,贮,嘱,主,祝,往,助,筑,珠,足,住,竹,铸,逐,组,祖,诸,猪,朱,株,族,注
谦	前,千,强,潜,迁,钱,歉,遣,墙,嫌,欠,腔,廉,兼,签,赚,抢,浅,铅,牵,枪
泰	台,太,抬,胎,态
徙	晰,戏,袭,析,悉,稀,习,吸,希,席,西,嘻,锡,细,隙,夕,息,溪,牺,系,惜,洗,喜,媳
娄	柔,楼,数,肉,漏
造	招,遭,罩,爪,灶,找,早,兆,藻,召,照,燥,糟,赵
策	测,彻,车,扯,撤,册,侧
古	姑,骨,股,故,苦,固,酷,鼓,雇,咕,库,孤,枯,谷,哭,裤,顾,估
抱	保,胞,暴,包,炮,宝,堡,泡,饱,薄,爆,报,跑
埋	迈,卖,童,理,著,里,麦,买,脉
周	州,轴,走,骤,调,昼,雕,奏,皱,宙,洲
疹	诊,争,整,珍,症,振,政,怎,挣,侦,证,睁,镇,阵,郑,真,针,蒸,震,贞,正,征
牺	晰,戏,袭,析,悉,稀,习,吸,希,席,西,嘻,锡,细,隙,夕,息,溪,系,惜,洗,喜,媳
瘦	收,搜,售,兽,受,守,疗,首,疼,寿,病,手,授
佛	抚,扶,忽,副,服,湖,富,糊,乎,赋,复,夫,沸,傅,妇,覆,幅,肤,呼,父,辅,伏,付,胡,符,户,互,弗,腹,赴,咐,缚,浮,府,福,护,虎,腐,辐,负,甫,附
禅	阐,缠,惨,参,肠,厂,唱,尝,偿,残,昌,蚕,场,畅,倡,常,颤,餐,产
镐	高,搞,靠,告,考,稿
巩	功,宫,控,工,孔,贡,弓,供,空,共,公,攻,恐,恭
纯	寸,村,存,醇,唇,春
蹄	体,踢,替,题,帝,梯,提
呜	物,吴,五,乌,雾,舞,屋,无,务,污,悟,午,伍,武,吾,误
叁	衫,珊,扇,丧,散,善,闪,陕,三,桑,山,嗓
迁	前,千,强,潜,钱,歉,谦,遣,墙,欠,腔,签,抢,纤,浅,铅,牵,枪
日	黎,厉,梨,理,李,利,立,离,礼,吏,厘,莉,历,哩,隶,丽,励,里,力,例,粒,璃
银	鹰,英,映,姻,吟,赢,影,因,迎,殷,隐,盈,应,印,阴,引,硬,营,颖,婴,音,饮
压	芽,押,雅,哑,鸦,鸭,崖,牙,呀,亚
炸	作,咋,杂,昨,扎
满	忙,蛮,漫,茫,慢,曼,盲
惊	禁,净,静,金,京,敬,凉,近,精,谅,劲,锦,筋,镜,津,晋,境,景,竟,浸,尽,巾,经,井,茎,警,颈,竞,掠,进,仅,睛,晶,紧,谨,今,径,斤
艰	碱,蒋,讲,匠,简,见,减,尖,箭,键,降,姜,剪,渐,奖,剑,件,健,建,江,疆,检,坚,将,兼,监,肩,鉴,间,舰,僵,践,奸,歼,浆
搭	答,打,给,塔,合,哈,拾,达,恰,大
光	广,贯,惯,罐,况,框,官,观,冠,管,灌,关,馆,狂,矿
药	姚,咬,摇,腰,邀,约,要,耀,遥
搔	稍,扫,梢,少,嫂,绍,哨,烧
硫	柳,纽,流,瘤,刘,牛,留,溜,扭,六
转	状,壮,赚,装,撞,砖,钻,庄,专
嘀	底,帝,弟,递,低,抵,蒂,第,滴,迪,堤,敌
缰	碱,蒋,讲,匠,简,见,减,尖,箭,键,降,姜,剪,渐,奖,剑,件,健,建,江,疆,检,坚,将,兼,监,肩,鉴,间,艰,舰,僵,践,奸,歼,浆
敬	禁,净,静,惊,金,京,近,精,劲,锦,筋,镜,津,晋,境,景,竟,浸,尽,巾,经,井,茎,警,颈,竞,进,仅,睛,晶,紧,谨,今,径,斤
璧	闭,笔,比,彼,逼,毕,壁,辟,蔽,鼻,碧,必,币,弊,避,臂
收	搜,瘦,售,兽,受,守,首,寿,手,授
鸭	芽,押,雅,压,哑,鸦,崖,牙,呀,亚
摹	默,莫,慕,漠,摸,沫,陌,墓,幕,膜,摩,末,墨,魔,抹,模,磨
蚤	招,遭,造,罩,爪,灶,找,早,兆,藻,召,照,燥,糟,赵
约	曰,越,药,的,岳,悦,跃,月,阅
卷	誉,捐,倦,券
税	髓,虽,碎,岁,睡,遂,随,水
播	玻,拨,勃,脖,博,膊,波,剥,驳,搏,伯,卜
抛	泡,跑,炮
旧	舅,究,久,酒,救,九,纠,就
法	罚,伐,哈,阀,乏,发
表	彪,标
紧	禁,净,静,惊,金,京,敬,近,精,劲,锦,筋,镜,津,晋,境,景,竟,浸,尽,巾,经,井,茎,警,颈,竞,进,仅,睛,晶,谨,今,径,斤
囚	球,求,丘,秋
冬	冻,懂,洞,动,东,董
霉	没,美,妹,海,梅,悔,枚,煤,每,眉,媒
因	鹰,英,映,姻,吟,赢,影,迎,殷,隐,盈,应,印,阴,引,硬,营,颖,婴,音,饮,银
缭	辽,疗,鸟,料,僚,尿,聊
捷	借,界,介,截,街,姐,皆,劫,戒,届,杰,接,洁,竭,阶,节,结,解,揭
耘	孕,允,运,匀,晕,动,云,蕴,韵
臼	舅,究,旧,久,酒,救,九,纠,就
犀	晰,戏,袭,析,悉,稀,习,吸,希,席,西,嘻,锡,细,隙,夕,息,溪,牺,系,惜,洗,喜,媳
弱	逻,螺,萝,络,若,落,裸,洛,罗
移	异,逸,够,役,医,抑,毅,义,一,益,议,疑,亦,乙,姨,宜,蚁,椅,多,译,疫,谊,亿,已,衣,依,遗,矣,易,仪,以,艺,伊,意,忆,翼
瞬	顺,孙,损
家	驾,夹,架,嫁,佳,钾,甲,假,加,嘉,贾,稼,价
晋	禁,净,静,惊,金,京,敬,近,精,劲,锦,筋,镜,津,境,景,竟,浸,尽,巾,经,井,茎,警,颈,竞,进,仅,睛,晶,紧,谨,今,径,斤
尿	辽,疗,鸟,料,僚,聊
遍	变,辩,扁,编,辨,鞭,篇,骗,便,边,偏
触	础,储,粗,初,出,楚,促,畜,厨,处,除
已	异,逸,役,医,抑,毅,义,一,益,议,疑,亦,乙,姨,宜,蚁,椅,移,译,疫,谊,亿,衣,依,遗,矣,易,仪,以,艺,伊,意,忆,翼
杭	含,妨,房,寒,防,汉,仿,航,纺,方,罕,喊,涵,韩,放,芳,函,访,旱,汗
扯	测,策,彻,车,撤,册,侧
旋	悬,选,玄,宣
红	鸿,轰,哄,洪,宏
宪	享,项,显,乡,象,献,鲜,线,香,县,贤,想,现,翔,祥,箱,掀,橡,相,腺,弦,仙,嫌,响,详,险,限,先,纤,陷,像,湘,向,闲
瓤	朗,郎,嚷,然,壤,让,染,浪,燃,狼,廊
宵	效,萧,硝,销,孝,消,笑,晓,校,小,肖
竹	阻,柱,煮,驻,租,贮,嘱,主,祝,助,筑,珠,足,住,铸,逐,组,祖,诸,猪,朱,株,族,注
励	逆,黎,厉,梨,理,李,边,利,立,离,礼,吏,动,厘,莉,历,哩,劫,隶,你,丽,拟,尼,力,里,泥,日,例,粒,璃
蟆	马,蚂,嘛,吗,麻,妈,码,玛,骂
腾	疼,藤
版	榜,斑,板,饭,邦,反,膀,半,傍,伴,帮,班,棒,搬,扮,办,颁,返,般
益	异,逸,役,医,抑,毅,义,一,议,疑,亦,乙,姨,宜,蚁,椅,移,译,疫,谊,亿,已,衣,依,遗,矣,易,仪,以,艺,伊,意,忆,翼
甜	天,填,田,甘,添
愕	恶,鹅,鄂,俄,饿,额
敏	命,鸣,明,民,名
桃	挑,陶,涛,萄,兆,讨,淘,套,逃,掏
埂	坑,跟,耕,更,根
乓	判,盼,盘,叛,潘,庞,攀,旁,胖
绿	女,虑,旅,铝,率,履,录,逮,吕,律,剥,碌,氯,驴
鞭	变,遍,辩,扁,编,辨,便,边
社	涉,设,色,舍,摄,蛇,射,舌
妨	凡,范,杭,泛,犯,饭,房,反,仿,航,纺,方,贩,烦,番,繁,旅,返,翻,放,芳,防,访
怯	切,窃,且
捣	盗,倒,岛,稻,导,蹈,刀,到,道
涧	碱,蒋,讲,匠,简,见,减,尖,箭,键,降,姜,剪,渐,奖,剑,件,健,建,江,疆,检,坚,将,兼,监,肩,鉴,间,艰,舰,僵,践,奸,歼,浆
夷	异,逸,役,医,抑,毅,义,一,益,议,疑,亦,乙,姨,宜,蚁,椅,移,译,疫,谊,亿,已,衣,依,遗,矣,易,仪,以,艺,伊,意,忆,翼
研	焰,氧,阳,厌,严,言,养,验,颜,洋,央,沿,样,宴,燕,咽,秧,扬,盐,眼,炎,艳,烟,延,演,杨,掩,衍,仰,羊,岩
燥	招,遭,造,罩,爪,灶,找,早,兆,藻,召,照,操,糟,赵
内	泪,蕾,类,勒,雷,累,呐,纳
醉	嘴,最,罪,配,追,酬,酒
销	萧,孝,笑,校,梢,效,稍,晓,小,肖,悄,哨,硝,消
文	温,吻,翁,纹,稳,问,闻
弯	万,汪,往,网,湾,忘,亡,旺,完,玩,顽,望,碗,挽,晚,妄,王
编	变,遍,辩,扁,辨,鞭,篇,骗,便,边,偏
钳	前,千,强,潜,甘,迁,钱,歉,谦,遣,墙,甜,欠,腔,签,抢,浅,铅,牵,枪
仰	焰,氧,阳,厌,严,言,养,验,颜,洋,央,沿,样,宴,燕,咽,秧,扬,盐,研,眼,炎,艳,烟,延,演,杨,掩,衍,羊,岩
意	异,逸,役,医,抑,毅,义,一,益,议,疑,亦,乙,姨,宜,蚁,椅,移,译,疫,谊,亿,已,衣,依,遗,矣,易,仪,以,艺,伊,忆,翼
笙	生,审,渗,婶,伸,升,身,绳,肾,省,什,慎,圣,声,申,牲,神,剩,深,沈,僧,胜,甚,盛
铸	阻,柱,煮,涛,驻,寿,租,贮,嘱,主,祝,助,筹,筑,珠,足,住,竹,逐,组,祖,诸,猪,朱,株,族,注
吆	姚,咬,摇,腰,邀,要,耀,药,遥
颈	禁,净,静,惊,金,京,敬,近,精,劲,锦,筋,镜,津,晋,境,景,竟,浸,尽,巾,经,井,茎,警,竞,进,仅,睛,晶,紧,谨,今,径,斤
癣	悬,选,旋,玄,宣
棉	勉,面,免,绵,锦,眠
堂	坦,滩,躺,谈,倘,碳,糖,炭,探,贪,坛,塘,汤,唐,趟,叹,摊
隶	逆,黎,厉,梨,理,李,利,立,离,礼,吏,厘,莉,历,哩,你,丽,拟,尼,励,力,里,泥,日,例,粒,璃
狸	逆,黎,厉,梨,理,李,利,立,离,童,礼,吏,厘,莉,历,埋,著,哩,隶,你,丽,拟,尼,励,力,里,泥,日,例,粒,璃
侥	胶,骄,郊,焦,角,搅,脚,较,缴,教,交,轿,娇,叫
坡	玻,披,皮,波,疲,婆,迫,泊,破,彼,被,皱,泼,颇
皿	监,命,鸣,盒,猛,盐,明,民,名,孟,盆,敏
幽	游,友,优,由,又,邮,犹,油,悠,右,忧,有,诱,幼,尤
狂	琴,广,况,框,王,矿,斑,班,宽,光,款
咙	农,绒,溶,熔,容,笼,浓,融,龙,隆,荣,拢,垄,弄
其	汽,期,岂,骑,凄,栖,棋,气,奇,齐,斯,旗,起,弃,歧,器,企,漆,戚,七,契,启,妻,欺
蒋	碱,讲,匠,简,见,减,尖,箭,键,降,姜,剪,渐,奖,剑,件,健,建,江,疆,检,坚,将,兼,监,肩,鉴,间,艰,舰,僵,践,奸,歼,浆
廊	懒,郎,篮,烂,栏,滥,嚷,囊,浪,拦,兰,览,让,蓝,朗,狼,壤
尤	游,友,优,由,又,邮,犹,油,幽,悠,右,忧,有,诱,幼
长	葬,账,展,粘,章,占,掌,涨,脏,障,仗,张,战,沾,丈,胀,帐,站
嚼	掘,觉,决,绝
淆	效,萧,硝,销,孝,消,笑,晓,校,小,肖
喊	凡,含,范,杭,泛,犯,饭,减,寒,反,汉,航,贩,罕,烦,番,繁,返,翻,涵,韩,函,旱,汗
督	叔,渡,杜,赌,独,毒,淑,堵,读,肚,度
琐	所,说,锁,索,缩
自	字,执,肢,滞,址,姿,致,稚,旨,志,直,滋,制,脂,织,支,汁,知,纸,指,资,兹,职,止,质,紫,芝,值,智,之,置,秩,治,子,至,殖,植,只,枝
悲	贝,菲,杯,排,匪,非,卑,北,背,碑,备,被,辈,倍
努	录,鲁,露,怒,炉,路,鹿,芦,碌,奴,卢,陆
有	游,友,优,由,又,邮,犹,油,幽,悠,右,忧,诱,幼,尤
端	喘,瑞,短,锻,断,段
壤	朗,郎,嚷,然,让,染,浪,燃,狼,廊
省	生,审,渗,婶,伸,升,身,绳,肾,什,慎,圣,声,申,牲,神,剩,深,沈,僧,胜,甚,盛
握	窝,我,卧
徐	序,吁,需,除,绪,许,斜,叙,须,途,余,蓄,涂,续,虚
辐	抚,扶,忽,副,服,湖,富,糊,乎,赋,复,夫,傅,妇,覆,幅,肤,呼,父,佛,辅,伏,付,胡,符,户,互,弗,腹,赴,咐,缚,浮,府,福,护,虎,腐,负,甫,附
湖	抚,扶,忽,副,服,富,糊,乎,赋,复,夫,傅,妇,覆,幅,肤,呼,父,佛,辅,伏,付,胡,符,户,互,弗,腹,赴,咐,缚,浮,府,福,护,虎,腐,辐,负,甫,附
战	暂,贴,账,展,粘,章,长,占,掌,涨,障,仗,张,咱,沾,丈,胀,赞,帐,站
殉	训,讯,旬,寻,迅,询,逊,循,巡
狱	与,裕,玉,育,愚,誉,语,豫,遇,雨,宇,愉,喻,于,愈,渔,预,余,予,欲,寓,域,郁,娱,羽,舆,鱼,御,浴
嘶	市,实,司,寺,尸,四,使,拾,室,适,食,世,私,是,施,逝,势,死,识,师,石,试,诗,始,释,蚀,斯,撕,十,湿,思,式,似,士,示,氏,丝,史,事,饲,视,驶,时,饰,失
百	摆,拜,白,柏,败
磨	默,莫,漠,摸,麻,沫,陌,膜,摩,末,墨,魔,抹,模
雪	灵,穴,扫,霜,寻,学,雷,雾,雨,血,削
而	耳,尔,儿,二
屡	绿,女,虑,旅,铝,率,履,吕,律,氯,驴
迭	跌,爹,蝶,叠
袍	泡,饱,包,跑,抛,抱,炮
鹃	捐,倦,卷
迹	基,挤,集,济,鸡,寂,脊,际,机,既,疾,祭,技,亦,及,辑,吉,恋,级,急,变,极,蛮,积,饥,即,几,击,己,绩,肌,激,忌,计,季,继,寄,籍,剂,记,纪
霎	霜,撒,雾,雨,砂,沙,洒,杀,厦,雷,傻,纱,萨,刹,啥,雪
噩	恶,鹅,鄂,俄,饿,额
珊	上,衫,赏,陕,三,商,散,善,伤,闪,山,扇,尚
射	社,涉,设,身,躲,色,舍,摄,蛇,舌
岩	焰,氧,阳,厌,严,言,养,验,颜,洋,央,沿,样,宴,燕,咽,秧,扬,盐,研,眼,炎,艳,烟,延,演,杨,掩,衍,仰,羊
氯	绿,女,虑,旅,铝,率,履,吕,律,驴
轿	胶,骄,桥,侨,郊,焦,角,搅,乔,脚,较,缴,教,交,娇,叫
茸	绒,溶,熔,容,笼,融,耸,龙,隆,耻,荣,职,拢,联,垄,耳
蝇	鹰,英,映,姻,吟,赢,影,因,迎,殷,隐,盈,应,印,阴,引,硬,营,颖,婴,音,饮,银
婉	万,汪,往,网,湾,忘,亡,旺,完,玩,顽,望,碗,挽,晚,妄,王,弯
狐	抚,扶,忽,副,服,湖,富,糊,抓,乎,赋,复,夫,傅,妇,覆,幅,肤,瓜,呼,父,佛,辅,伏,付,胡,符,户,互,弗,腹,赴,咐,缚,浮,孤,府,福,护,虎,腐,辐,负,甫,附
惨	渗,阐,苍,藏,缠,参,残,仓,蚕,禅,颤,舱,餐,产
柜	规,跪,鬼,巨,距,拒,愧,桂,贵,硅,轨,亏,龟,矩,归,溃
胧	农,绒,溶,熔,容,笼,浓,融,龙,隆,荣,拢,垄,弄
鳞	淋,龄,铃,另,您,磷,邻,陵,灵,玲,林,零,临,领,令,凌,岭
盹	敦,顿,蹲,吨,盾
叠	跌,爹,蝶
故	姑,骨,股,苦,固,酷,鼓,雇,咕,库,孤,古,枯,谷,哭,裤,顾,估
唬	抚,扶,忽,副,服,湖,富,糊,乎,赋,复,夫,傅,妇,覆,幅,肤,呼,父,佛,辅,伏,付,胡,符,户,互,弗,腹,赴,咐,缚,浮,府,福,护,虎,腐,辐,负,甫,附
黔	前,千,强,潜,迁,钱,歉,谦,遣,墙,欠,腔,签,抢,浅,铅,牵,枪
资	次,字,执,肢,滞,址,姿,致,稚,旨,志,直,滋,制,脂,织,支,汁,知,纸,指,兹,自,职,止,质,紫,芝,值,智,之,置,秩,治,子,至,殖,植,只,枝
闷	闭,蒙,萌,猛,闯,门,闪,们,梦,盟,孟,阔,闲
冰	饼,兵,滨,并,丙,宾,病
囊	朗,难,郎,男,南,浪,狼,廊
蝠	抚,扶,忽,副,服,湖,富,糊,乎,赋,复,夫,傅,妇,覆,幅,肤,呼,父,佛,辅,伏,付,胡,符,户,互,弗,腹,赴,咐,缚,浮,府,福,护,虎,腐,辐,负,甫,附
叼	吊,调,雕,掉
似	市,实,司,寺,尸,四,使,拾,室,适,食,世,私,是,施,逝,势,死,识,师,石,试,诗,始,释,蚀,斯,撕,十,湿,思,式,士,示,氏,丝,史,事,饲,视,驶,时,饰,失
朝	巢,超,操,抄,曹,槽,撤,吵,草,潮
无	物,吴,五,乌,雾,舞,屋,务,污,悟,午,伍,呜,武,吾,误
门	闭,蒙,萌,猛,闯,闪,们,梦,盟,闷,孟,阔,闲
命	鸣,明,民,名,敏
苍	藏,惨,参,肠,厂,唱,尝,偿,残,昌,仓,蚕,场,畅,倡,舱,常,餐
震	辱,诊,争,整,珍,症,振,唇,政,怎,挣,侦,证,睁,镇,阵,郑,真,针,蒸,贞,正,征,晨
娃	哇,封,佳,桂,崖,挂,挖,瓦,蛙
剔	体,锡,踢,易,替,题,梯,提
哨	嫂,绍,梢,烧,稍,肖,悄,扫,销,少,硝,消
龄	淋,冷,铃,另,磷,邻,陵,灵,玲,凝,林,零,临,怜,领,令,凌,岭,宁
腿	退,推
筋	禁,净,静,惊,金,京,敬,近,精,劲,锦,镜,津,晋,境,景,竟,浸,尽,巾,经,井,茎,警,颈,竞,进,仅,睛,晶,紧,谨,今,径,斤
嗓	丧,散,伤,上,三,赏,桑,尚,商
牛	柳,纽,流,瘤,硫,刘,留,溜,扭,六
搁	葛,格,隔,课,个,歌,棵,哥,可,革,胳,壳,阁,克,各,科,割,渴,客,鸽,颗,刻,戈
叫	胶,骄,郊,焦,角,搅,脚,较,缴,教,交,轿,娇
槛	看,干,康,感,堪,甘,肝,赶,坎,滥,敢,刊,抗,监,杆,砍,炕
府	抚,扶,忽,副,服,湖,富,糊,乎,赋,复,夫,傅,妇,覆,幅,肤,呼,父,佛,辅,伏,付,胡,符,户,互,弗,腹,赴,咐,缚,浮,福,护,虎,腐,辐,负,甫,附
丑	凑,纽,仇,愁,筹,臭,抽,瞅,酬,畴,扭
趋	取,屈,趣,驱,越,起,趟,超,渠,徒,躯,区,去,曲,走
键	碱,金,蒋,讲,匠,简,见,链,减,钱,尖,箭,铜,降,姜,剪,渐,奖,剑,件,健,建,江,疆,检,坚,针,将,兼,监,肩,鉴,间,艰,舰,僵,践,奸,歼,浆
卯	茅,貌,帽,冒,毛,茂,贸,猫,矛
峦	软,亦,变,乱,蛮,暖,卵,迹,恋
鸿	轰,哄,洪,红,宏
磅	榜,斑,板,邦,膀,半,傍,伴,帮,班,棒,搬,扮,办,版,颁,旁,般
虑	绿,女,旅,铝,率,履,虎,虚,吕,律,氯,驴
粥	奏,州,宙,昼,洲,走,轴,皱,骤,周
照	招,遭,造,罩,爪,灶,找,早,兆,藻,召,燥,糟,赵
妓	基,挤,集,济,鸡,寂,脊,际,机,既,疾,祭,技,及,辑,吉,迹,级,急,极,积,饥,即,几,击,己,绩,肌,激,忌,计,季,继,寄,籍,剂,记,纪
届	借,界,介,截,街,姐,皆,劫,捷,戒,杰,接,洁,竭,阶,节,结,解,揭
杨	焰,氧,阳,厌,严,言,养,验,颜,洋,央,沿,样,肠,宴,燕,咽,秧,扬,盐,研,场,眼,炎,艳,烟,延,演,掩,衍,汤,仰,羊,岩
梨	逆,黎,厉,理,李,利,立,离,礼,吏,厘,莉,历,哩,隶,你,丽,拟,尼,励,力,里,泥,日,例,粒,璃
赃	葬,障,丈,暂,账,胀,赞,帐,掌,仗,张,咱,章,长,涨,脏
论	轮,润,伦
诫	借,界,介,截,街,姐,皆,劫,捷,戒,届,杰,接,洁,竭,阶,节,结,解,揭
颂	宋,松,耸,送,讼
坤	昆,申,困,神,伸,棍,滚
疾	基,挤,集,济,鸡,寂,脊,际,机,既,祭,技,及,辑,吉,迹,级,急,极,积,饥,即,几,击,己,绩,肌,激,忌,计,季,继,寄,籍,剂,记,纪
闲	享,闭,项,门,宪,显,乡,象,献,鲜,线,香,县,贤,想,现,翔,祥,箱,掀,橡,阔,相,腺,弦,闯,闪,仙,嫌,响,详,险,限,先,纤,陷,闷,像,湘,向
增	争,症,政,怎,挣,证,睁,郑,僧,蒸,曾,正,征,整
泡	饱,包,跑,抛,抱,炮
绘	辉,慧,灰,惠,会,恢,汇,挥,悔,毁,徽,回
邮	优,犹,抽,幽,游,由,又,庙,悠,忧,有,诱,袖,油,右,迪,幼,友,尤
骤	奏,州,宙,昼,洲,走,轴,皱,周
萍	频,苹,品,凭,平,拼,屏,瓶,贫,评
夏	下,吓,霞,峡,狭,瞎,辖
蓄	许,序,叙,续,须,需,徐,虚,吁,绪
逢	冯,风,疯,蜂,份,衡,恒,氛,锋,缝,芬,峰,粉,封,凤,奉,丰,粪,蓬,横,奋,哼,分,坟,纷,愤
双	霜,爽
叔	诉,疏,束,数,蔬,淑,署,树,宿,枢,肃,输,术,属,抒,俗,素,书,鼠,熟,舒,速,苏,塑,督,述,竖,殊
享	项,宪,显,乡,象,献,鲜,线,香,县,贤,想,现,翔,祥,箱,掀,橡,相,腺,弦,仙,嫌,响,详,险,限,先,纤,陷,像,湘,向,闲
赛	塞,寒,晒
涯	芽,押,鸭,挂,崖,娃,压,哑,桂,牙,蛙,亚,雅,封,佳,鸦,呀
布	不,步,补,捕,部
期	汽,岂,骑,凄,栖,棋,气,奇,齐,斯,旗,起,其,弃,歧,器,企,漆,戚,七,契,启,妻,欺
紫	字,执,肢,滞,址,姿,致,稚,旨,志,直,滋,制,脂,织,此,支,柴,汁,知,纸,指,资,兹,自,职,些,止,质,芝,值,智,之,置,秩,治,子,至,殖,植,只,枝
锅	括,国,扩,过,祸,郭,裹,果,阔
授	收,搜,瘦,售,兽,受,守,首,寿,手
案	暗,氨,岸,俺,按,昂,安
祀	市,实,司,寺,尸,四,使,拾,室,适,食,世,私,是,施,逝,势,死,识,师,石,试,诗,始,释,蚀,斯,撕,十,湿,思,式,似,士,示,氏,丝,史,事,饲,视,驶,时,饰,失
焉	焰,氧,症,惩,阳,厌,严,言,养,验,颜,证,洋,央,沿,歪,样,宴,燕,咽,秧,扬,盐,研,眼,炎,艳,烟,延,演,杨,掩,衍,仰,正,羊,征,岩
倔	屈,出,掘,觉,决,绝
秸	借,界,介,截,街,姐,皆,劫,捷,戒,届,杰,接,洁,竭,阶,节,结,解,揭
砰	棚,碰,膨,朋,喷,捧,彭,盆,蓬
货	祸,贝,伙,惑,或,贪,霍,账,财,贺,获,负,责,贫,活,火
从	匆,聪,纵,冲,众,崇,充,丛,虫
汁	字,执,肢,滞,址,姿,致,稚,旨,志,直,滋,制,脂,织,支,知,纸,指,资,兹,自,职,止,质,紫,芝,值,智,之,置,秩,治,子,至,殖,植,只,枝
私	市,实,司,寺,尸,四,使,拾,室,适,食,世,是,施,逝,势,死,识,师,石,试,诗,始,释,蚀,斯,撕,十,湿,思,式,似,士,示,氏,丝,史,事,饲,视,驶,时,饰,失
滥	懒,郎,篮,然,南,烂,难,栏,染,浪,拦,兰,廊,览,燃,蓝,监,男,朗,狼
弘	鸿,轰,哄,洪,红,宏
挺	停,艇,亭,庭,听,厅,廷
粉	冯,风,狠,疯,蜂,份,锋,氛,缝,很,芬,峰,封,凤,奉,丰,粪,奋,恨,愤,逢,分,坟,纷,痕
鸣	命,鸟,鹅,明,民,岛,名,敏
软	乱,卵
捎	嫂,绍,梢,烧,稍,肖,悄,哨,扫,销,少,硝,消
碟	跌,泄,爹,世,蝶,叠
肮	暗,氨,岸,俺,案,按,昂,安
外	歪
容	绒,溶,熔,拢,笼,融,龙,隆,荣,垄
季	基,挤,集,济,鸡,寂,脊,际,机,既,疾,祭,技,及,辑,吉,迹,级,急,极,积,饥,即,几,击,己,绩,肌,激,忌,计,继,寄,籍,剂,记,纪
糠	杠,看,港,康,堪,坎,刊,岗,刚,纲,抗,砍,钢,炕
棍	昆,困,滚
饥	基,挤,集,济,鸡,寂,脊,际,机,既,疾,祭,技,及,辑,吉,迹,凯,级,急,极,积,即,几,击,己,绩,肌,激,忌,计,季,继,寄,籍,剂,记,纪
述	诉,疏,束,数,蔬,淑,署,树,叔,宿,枢,肃,输,术,属,抒,俗,素,书,鼠,熟,舒,速,苏,塑,竖,殊
推	维,退,堆,腿,住,准
瘤	柳,纽,流,硫,刘,牛,留,溜,扭,六
煤	没,美,妹,梅,枚,烧,媒,谋,霉,某,炎,灾,每,眉,火
涌	痛,泳,桶,庸,用,拥,永,勇,通
术	诉,疏,束,数,蔬,淑,署,树,叔,宿,枢,肃,输,属,抒,俗,素,书,鼠,熟,舒,速,苏,塑,述,竖,殊
赁	淋,龄,铃,另,您,磷,邻,陵,灵,玲,林,零,临,领,令,凌,岭
锣	逻,弱,诺,螺,萝,若,络,落,裸,洛,罗
我	窝,卧,握
惰	躲,多,夺,朵
钓	吊,调,的,雕,约,掉
屹	异,逸,役,医,抑,毅,义,一,益,议,疑,亦,乙,姨,宜,蚁,椅,移,译,疫,谊,亿,已,衣,依,遗,矣,易,仪,以,艺,伊,意,忆,翼
溢	异,逸,役,医,抑,毅,义,一,益,议,疑,亦,乙,姨,宜,蚁,椅,移,译,疫,谊,亿,已,衣,依,遗,矣,易,仪,以,艺,伊,意,忆,翼
煞	沙,纱,萨,刹,洒,杀,啥,撒,厦,砂,皱,傻
唯	畏,慰,委,胃,惟,威,味,围,危,伟,未,为,位,伪,谓,尾,卫,维,纬,微,魏,喂,违
蒙	萌,猛,门,们,梦,盟,闷,孟
份	冯,风,狠,疯,蜂,锋,氛,缝,很,芬,峰,粉,封,凤,奉,丰,粪,奋,恨,愤,逢,分,坟,纷,痕
谓	畏,慰,委,胃,惟,威,味,围,危,伟,未,为,位,伪,尾,卫,维,纬,微,魏,喂,唯,违
棋	汽,期,岂,骑,凄,栖,气,奇,齐,旗,起,其,弃,歧,器,企,漆,戚,七,契,启,妻,欺
响	享,项,宪,显,乡,象,献,鲜,线,香,县,贤,想,现,翔,祥,箱,掀,橡,相,腺,弦,仙,嫌,详,险,限,先,纤,陷,像,湘,向,闲
佣	泳,庸,用,涌,拥,永,勇
守	过,寿,兽,村,衬,付,手,寸,售,首,讨,瘦,对,收,授,搜,受,时
寄	基,挤,集,济,鸡,寂,脊,际,机,既,疾,祭,技,及,辑,吉,迹,级,急,极,积,饥,即,几,击,己,绩,肌,激,忌,计,季,继,籍,剂,记,纪
懒	郎,篮,然,南,烂,难,栏,滥,染,浪,拦,兰,廊,览,燃,蓝,男,朗,狼
引	鹰,英,映,姻,吟,赢,影,因,迎,殷,隐,盈,应,印,阴,硬,营,颖,婴,音,饮,银
雹	保,霜,胞,雾,雨,暴,包,宝,堡,饱,雷,抱,薄,爆,报,雪
诸	阻,柱,堵,煮,驻,租,署,贮,绪,嘱,主,祝,助,筑,珠,足,者,住,竹,铸,赌,逐,组,都,祖,猪,朱,株,族,注
脾	披,譬,匹,皮,辟,疲,牌,卑,碑,屁,批
董	冻,懂,洞,冬,动,东
牡	亩,木,牧,姆,墓,幕,慕,穆,目,母
郁	与,裕,玉,育,愚,誉,语,豫,遇,雨,宇,愉,喻,于,愈,渔,预,余,予,欲,寓,域,狱,娱,羽,舆,鱼,御,浴
豚	吞
洁	借,界,介,截,吉,街,姐,皆,劫,捷,戒,届,杰,接,竭,阶,节,结,解,揭
仗	葬,账,展,粘,章,长,占,掌,涨,脏,障,张,战,沾,丈,胀,帐,站
沃	窝,我,卧,跃,握
螃	判,盼,盘,叛,潘,庞,攀,旁,胖
枝	字,执,肢,滞,址,姿,致,稚,旨,志,直,滋,制,脂,织,技,支,汁,知,纸,指,资,兹,自,职,鼓,止,质,歧,紫,芝,值,智,之,置,秩,治,子,至,殖,植,只
年	娘,链,恋,连,练,炼,联,怜,廉,念,莲,帘,脸
漓	逆,黎,厉,梨,理,李,利,立,离,礼,吏,厘,莉,历,哩,隶,你,丽,拟,尼,励,力,里,泥,日,例,粒,璃
众	忠,仲,纵,从,终,重,总,宗,种,综,钟,衷,丛,中,踪,肿
海	害,悔,梅,咳,霉,每,还,孩
型	醒,行,杏,兴,新,信,幸,欣,性,辛,心,姓,形,星,刑,开
未	畏,慰,委,胃,惟,威,味,围,危,伟,为,位,伪,谓,尾,卫,维,纬,微,魏,喂,唯,违
雄	胸,兄,熊,凶
雁	焰,氧,阳,厌,严,言,养,验,颜,洋,央,沿,样,宴,燕,咽,秧,扬,盐,研,眼,炎,艳,烟,延,演,杨,掩,衍,仰,羊,岩
翠	摧,吹,垂,脆,锤,催,粹,崔
粪	冯,风,狠,疯,蜂,份,锋,氛,缝,很,芬,峰,粉,封,凤,奉,丰,奋,恨,愤,逢,分,坟,纷,痕
矣	异,逸,役,医,抑,毅,义,一,益,议,疑,亦,乙,姨,宜,蚁,椅,移,译,疫,谊,亿,已,衣,依,遗,易,仪,以,艺,伊,意,忆,翼
玛	马,蚂,嘛,吗,麻,妈,码,骂
将	碱,蒋,讲,匠,简,见,减,尖,箭,键,降,姜,剪,渐,奖,剑,件,健,建,江,疆,检,坚,兼,监,肩,鉴,间,艰,舰,僵,践,奸,歼,浆
悉	晰,戏,袭,析,稀,习,吸,希,席,西,嘻,锡,细,隙,夕,息,溪,牺,系,惜,洗,喜,媳
沾	暂,贴,账,展,粘,章,长,占,掌,涨,障,仗,张,咱,战,丈,胀,赞,帐,站
诽	菲,黑,匪,肥,肺,非,嘿,废,费,飞,沸
童	撞,理,痛,铜,筒,埋,著,通,统,同,桶,里
啊	阿
侯	否,厚,猴,候,后,喉
吮	瞬,顺,孙,损
祟	髓,虽,税,碎,岁,睡,遂,随,水
英	鹰,映,姻,吟,赢,影,因,迎,殷,隐,盈,应,印,阴,引,硬,营,颖,婴,音,饮,银
喷	棚,碰,膨,朋,愤,捧,彭,盆,蓬
礼	逆,黎,厉,梨,理,李,利,立,离,吏,厘,莉,历,哩,隶,你,丽,拟,尼,励,力,里,泥,日,例,粒,璃
幕	莫,亩,慕,漠,墓,母,木,牧,姆,模,穆,摸,目
托	拖,驼,脱,妥
掂	奠,垫,典,淀,电,殿,店,点,颠
袖	修,羞,绣,由,秀,油,庙,抽,休,邮,迪,朽
拿	钠,辣,拉,娜,蜡,哪,啦,那,呐,纳,腊
执	字,肢,滞,址,姿,致,稚,旨,志,直,滋,制,脂,织,支,汁,知,纸,指,资,兹,自,职,止,质,紫,芝,值,智,之,置,秩,治,子,至,殖,植,只,枝
臂	闭,笔,比,彼,逼,毕,壁,蔽,鼻,碧,必,币,弊,避
痴	词,次,池,齿,瓷,刺,磁,持,驰,此,辞,耻,斥,尺,迟,慈,吃,翅,雌,赤
赔	胚,培,配,佩,陪
蠢	寸,村,存,醇,纯,唇,春
妮	逆,黎,厉,梨,理,李,利,立,离,礼,吏,厘,莉,历,哩,隶,你,丽,拟,尼,励,力,里,泥,例,粒,璃
种	忠,仲,纵,终,众,重,总,宗,综,钟,衷,中,踪,肿
迟	词,次,池,齿,瓷,刺,磁,持,驰,此,辞,耻,斥,尺,慈,吃,翅,雌,赤
农	拢,笼,弄,浓,龙,隆,垄
规	跪,鬼,愧,桂,贵,硅,轨,亏,龟,柜,归,溃
鲍	报,堡,薄,爆,饱,包,保,胞,抱,暴,宝
浊	卓,左,座,桌,作,独,做,昨,虫,蚕,捉,蛋,坐
欺	汽,期,岂,骑,凄,栖,棋,气,奇,齐,斯,旗,起,其,弃,歧,器,企,漆,戚,七,契,启,妻
蓉	绒,溶,熔,拢,容,笼,融,龙,隆,荣,垄
谚	焰,氧,阳,厌,严,言,养,验,颜,洋,央,沿,样,宴,燕,咽,秧,扬,盐,研,眼,炎,艳,烟,延,演,杨,掩,衍,仰,羊,岩
句	巨,距,惧,拒,聚,俱,举,居,据,剧,菊,局,矩,拘,具
嚣	效,萧,硝,销,孝,消,笑,晓,校,小,肖
跌	爹,蝶,叠
振	辱,诊,争,整,珍,症,唇,政,怎,挣,侦,证,睁,镇,阵,郑,真,针,蒸,震,贞,正,征,晨
恐	功,宫,控,巩,工,孔,贡,弓,供,空,共,公,攻,恭
腋	业,叶,野,爷,夜,冶,也,液,页
责	账,遮,贫,浙,者,泽,货,贪,著,财,贝,这,择,哲,折,贺,负,则,着
障	葬,账,展,粘,章,长,占,掌,涨,脏,仗,张,战,沾,丈,胀,帐,站
厘	逆,黎,厉,梨,理,李,利,立,离,礼,吏,莉,历,哩,隶,你,丽,拟,尼,励,力,里,泥,日,例,粒,璃
瑟	社,涉,设,琴,色,王,舍,斑,狂,摄,蛇,射,班,舌
雨	与,裕,玉,育,愚,誉,霜,语,豫,遇,雾,宇,愉,喻,于,愈,渔,预,余,予,欲,寓,雷,域,郁,狱,娱,羽,舆,鱼,御,浴,雪
栽	摘,窄,寨,宰,再,灾,在,载,宅,债,仔
畔	判,盼,盘,叛,潘,庞,攀,旁,胖
浩	耗,豪,好,号,毫
缺	块,快,雀,决,确,却
短	锻,断,段,端
啼	体,踢,替,题,帝,梯,提
辫	编,边,遍,辟,辞,变,辩,扁,辨,宰,便,辛,辨,辣,鞭,避
七	汽,期,岂,骑,凄,栖,棋,气,奇,齐,旗,起,其,弃,歧,器,企,漆,戚,契,启,妻,欺
迷	秘,蜜,弥,米,断,密,泌,继
筛	塞,赛,晒
随	髓,虽,税,碎,岁,睡,遂,水
允	孕,运,匀,晕,云,蕴,韵
堪	看,干,康,感,甘,肝,赶,坎,敢,刊,抗,杆,砍,甚,炕
轨	规,跪,鬼,愧,桂,贵,硅,亏,龟,柜,归,溃
寥	辽,疗,鸟,料,僚,尿,聊
扛	杠,看,港,康,堪,坎,刊,岗,刚,纲,抗,砍,钢,炕
廓	括,国,扩,过,郭,锅,裹,果,阔
秽	绘,辉,慧,灰,惠,会,恢,汇,挥,悔,毁,徽,回
仿	凡,范,杭,泛,犯,妨,饭,房,反,航,纺,方,贩,烦,番,繁,旅,返,翻,放,芳,防,访
莲	梁,凉,谅,良,链,辆,恋,亮,连,练,炼,联,两,怜,廉,粮,念,年,量,帘,脸
驳	玻,拨,勃,脖,博,播,膊,波,剥,搏,伯,卜
粱	梁,凉,谅,娘,良,链,辆,恋,亮,连,练,炼,联,两,怜,廉,粮,莲,量,帘,脸
肿	忠,仲,纵,终,众,重,总,宗,种,综,钟,衷,中,踪
榕	绒,溶,熔,拢,容,笼,融,龙,隆,荣,垄
瓜	刮,夸,抓,寡,挂,跨,孤
热	乐,惹,了
哇	娃,挖,瓦,蛙
宦	荒,缓,皇,惶,幻,煌,环,欢,黄,患,换,晃,慌,唤
怎	增,阵,震,诊,贞,珍,镇,振,真,针,侦
掠	略,惊,京,凉,谅,景
赘	嘴,傲,最,罪,醉,追
恭	功,宫,控,巩,工,孔,贡,弓,供,空,共,公,攻,恐
洽	恰
鬓	饼,兵,冰,滨,并,丙,宾,病
荐	碱,蒋,讲,匠,简,见,减,尖,箭,键,降,姜,剪,渐,奖,剑,件,健,建,江,疆,检,坚,将,兼,监,肩,鉴,间,艰,舰,僵,践,奸,歼,浆
辜	姑,骨,股,故,苦,固,酷,鼓,雇,咕,库,孤,古,枯,谷,哭,裤,顾,估
褒	报,堡,薄,爆,饱,包,保,胞,抱,暴,宝
碾	展,娘,链,恋,连,练,炼,联,怜,廉,念,莲,年,帘,脸
床	川,穿,船,闯,创,串,窗,传,喘
浇	胶,骄,郊,焦,饶,烧,角,搅,脚,较,缴,绕,教,交,轿,娇,叫
嫉	基,挤,集,济,鸡,寂,脊,际,机,既,疾,祭,技,及,辑,吉,迹,级,急,极,积,饥,即,几,击,己,绩,肌,激,忌,计,季,继,寄,籍,剂,记,纪
蚯	球,求,丘,秋
偏	遍,篇,片,扁,编,骗
冷	领,龄,令,铃,愣,邻,岭,能,仍,扔,怜,玲
婴	鹰,英,映,姻,吟,赢,影,因,迎,殷,隐,盈,应,印,阴,引,硬,营,颖,音,饮,银
训	讯,旬,寻,迅,询,逊,循,巡
事	市,实,司,寺,尸,四,使,拾,室,适,食,世,私,是,施,逝,势,死,识,师,石,试,诗,始,释,蚀,斯,撕,十,湿,思,式,似,士,示,氏,丝,史,饲,视,驶,时,饰,失
鞠	巨,距,惧,拒,聚,俱,举,居,据,剧,菊,局,矩,拘,句,具
杏	醒,行,兴,新,信,幸,欣,性,型,辛,心,姓,形,星,刑
瓷	词,次,池,齿,刺,磁,持,驰,此,辞,耻,斥,尺,迟,慈,吃,翅,雌,赤
套	陶,涛,萄,桃,讨,淘,逃,掏
枪	前,千,强,潜,迁,钱,歉,谦,仓,遣,墙,白,欠,腔,签,抢,浅,铅,牵
存	寸,村,醇,纯,唇,春
戴	呆,代,逮,袋,带,待,贷
咕	姑,骨,股,故,苦,固,酷,鼓,雇,库,孤,古,枯,谷,哭,裤,顾,估
惹	乐,了,热
毡	暂,账,展,粘,章,毛,长,占,掌,涨,障,仗,张,咱,战,沾,丈,胀,赞,帐,毫,站
装	状,壮,赚,转,撞,砖,庄,专
蹋	她,它,塔,拓,他,踏
鸽	葛,格,隔,课,个,歌,棵,哥,可,革,胳,壳,阁,克,各,科,割,渴,客,颗,刻,戈
呻	生,审,渗,婶,伸,升,身,绳,肾,省,什,慎,圣,声,申,牲,神,剩,深,沈,胜,甚,盛,森
值	字,执,肢,滞,址,姿,致,稚,旨,志,直,滋,制,脂,织,支,汁,知,纸,指,资,兹,自,职,止,质,紫,芝,智,之,置,秩,治,子,至,殖,植,只,枝
柄	并,栖,滨,材,村,内,病,呐,兵,框,林,饼,冰,木,宾,丙,纳
图	涂,土,徒,途,突,屠,兔,吐
左	卓,作,桌,捉,做,昨,座,坐
胸	兄,熊,凶,雄
第	底,帝,弟,递,低,抵,蒂,滴,迪,堤,敌
簇	础,储,粗,初,出,楚,促,畜,触,厨,处,除
确	缺,雀,却
匪	菲,黑,肥,排,肺,非,嘿,废,悲,辈,费,飞,沸
简	碱,蒋,讲,匠,见,减,尖,箭,键,降,姜,剪,渐,奖,剑,件,健,建,江,疆,检,坚,将,兼,监,肩,鉴,间,艰,舰,僵,践,奸,歼,浆
审	生,渗,婶,伸,升,身,绳,肾,省,什,慎,圣,声,申,牲,神,剩,深,沈,胜,甚,盛,森
玫	没,美,妹,梅,枚,煤,每,霉,眉,媒
供	功,宫,控,巩,工,孔,贡,弓,空,共,公,攻,恐,恭
安	暗,氨,岸,俺,案,按,昂
醋	础,储,粗,初,出,楚,促,畜,触,厨,处,除
鲜	群,享,项,宪,显,乡,象,献,线,香,县,贤,想,现,翔,祥,洋,箱,样,掀,橡,相,腺,弦,仙,嫌,响,详,险,限,鱼,先,纤,陷,羊,像,湘,向,闲
眶	广,况,狂,框,矿,宽,光,款
秘	迷,蜜,弥,米,密,必,泌
习	晰,戏,袭,析,悉,稀,吸,希,席,西,嘻,锡,细,隙,夕,息,溪,牺,系,惜,洗,喜,媳
栖	汽,期,岂,骑,凄,棋,气,材,村,奇,齐,旗,起,其,弃,歧,器,框,企,林,漆,戚,木,七,契,启,妻,欺
赦	社,涉,设,色,舍,摄,蛇,射,舌
鹅	恶,鄂,俄,鸟,我,额,鸣,岛,饿
鹏	棚,碰,膨,朋,喷,捧,彭,盆,蓬
停	艇,亭,庭,听,厅,廷,挺
傅	抚,扶,忽,副,服,湖,富,糊,博,乎,赋,复,夫,妇,覆,幅,肤,呼,父,佛,辅,搏,伏,付,胡,符,户,互,弗,腹,赴,咐,缚,浮,薄,府,福,护,虎,腐,辐,负,甫,附
迅	训,讯,旬,寻,询,逊,循,巡
儒	辱,录,炉,需,如,露,芦,入,陆,路,鲁,乳,碌,卢,鹿
艇	停,亭,庭,听,厅,廷,挺
涝	老,闹,牢,扰,捞,脑,恼,劳,饶,绕
跨	刮,瓜,夸,污,寡,挂
秦	轻,庆,琴,侵,晴,请,倾,清,氢,亲,青,情,勤
崎	汽,期,岂,骑,凄,栖,棋,气,奇,椅,齐,旗,起,其,弃,歧,器,企,漆,戚,七,契,启,妻,欺
奥	傲,澳,凹
喘	川,穿,船,闯,瑞,创,床,串,窗,传,端
传	川,穿,船,闯,创,床,串,窗,喘
春	寸,村,存,醇,纯,唇
伙	货,祸,惑,或,霍,获,活,火
骑	汽,期,岂,凄,栖,棋,气,奇,齐,旗,起,其,弃,歧,器,企,漆,戚,七,契,启,妻,欺
号	耗,豪,浩,好,毫
蒂	底,帝,弟,递,低,抵,第,滴,迪,堤,敌
凛	淋,龄,铃,另,您,磷,邻,陵,灵,玲,林,零,临,领,令,凌,岭
庸	泳,用,涌,拥,永,勇
秒	描,庙,苗,妙
领	淋,龄,顺,冷,铃,另,磷,须,邻,陵,灵,玲,页,凝,烦,林,零,临,顽,怜,令,凌,岭,宁
铅	前,千,强,潜,迁,钱,歉,谦,遣,墙,欠,腔,签,抢,浅,牵,枪
捕	不,膊,布,铺,步,搏,补,辅,甫,部
刨	泡,饱,包,跑,抛,抱,炮
遗	异,逸,役,医,抑,毅,义,一,益,议,疑,亦,乙,姨,宜,蚁,贵,椅,移,译,疫,谊,亿,已,衣,依,矣,易,仪,以,艺,伊,意,忆,溃,翼
清	轻,庆,琴,侵,晴,请,倾,猜,氢,亲,青,睛,情,勤,秦
辩	编,边,遍,辟,辞,变,扁,辨,宰,便,辛,辨,辣,鞭,避
盘	判,盼,叛,潘,庞,攀,旁,胖
裂	劣,猎,捏,烈,例,咧,列
皆	借,界,介,截,街,姐,谐,劫,捷,戒,届,杰,接,洁,竭,阶,节,结,解,揭
忽	抚,扶,副,服,湖,富,糊,乎,赋,复,夫,傅,妇,覆,幅,肤,呼,父,佛,辅,伏,付,胡,符,户,互,弗,腹,赴,咐,缚,浮,府,福,护,虎,腐,辐,负,甫,附
啥	沙,纱,萨,刹,洒,杀,撒,厦,砂,傻
夕	晰,戏,袭,析,悉,稀,习,吸,希,席,西,嘻,锡,细,隙,息,溪,牺,系,惜,洗,喜,媳
航	含,杭,妨,房,寒,防,汉,仿,纺,方,罕,喊,涵,韩,放,芳,舰,函,访,旱,汗
雇	姑,骨,股,故,苦,固,酷,鼓,咕,库,孤,古,枯,谷,哭,裤,顾,估
枉	斑,万,汪,琴,往,网,湾,忘,亡,旺,完,玩,顽,班,望,碗,挽,晚,妄,王,狂,弯
款	贯,馆,况,惯,灌,宽,狂,框,官,矿,管,罐,观,冠,关
源	员,元,愿,远,原,渊,怨,圆,援,冤,园,缘,袁,院
课	葛,格,隔,个,歌,棵,哥,可,革,胳,壳,阁,克,各,果,科,割,渴,客,鸽,颗,刻,戈
遂	髓,虽,税,碎,岁,睡,随,水
态	台,太,抬,泰,胎
了	乐,惹,热,呢
若	逻,弱,螺,萝,络,落,裸,洛,罗
静	禁,净,惊,金,京,敬,近,精,劲,锦,筋,镜,津,晋,境,景,竟,浸,尽,巾,经,井,茎,警,颈,竞,进,仅,睛,晶,紧,谨,今,径,斤
测	策,彻,车,扯,撤,册,侧,则
疯	冯,风,蜂,份,衡,恒,氛,锋,缝,芬,峰,粉,封,凤,奉,丰,粪,横,奋,哼,飘,逢,分,坟,纷,愤
娶	取,屈,趣,驱,渠,躯,区,去,曲,趋
亦	异,逸,役,医,抑,毅,义,一,益,议,疑,乙,姨,宜,蚁,椅,迹,移,恋,变,译,疫,蛮,谊,亿,已,衣,依,遗,矣,易,仪,以,艺,伊,意,忆,翼
泄	鞋,携,世,谢,斜,写,些,协,谐,械,歇,邪,蝶,卸,胁
霄	效,萧,硝,销,孝,消,笑,晓,校,小,肖
屠	涂,土,徒,途,突,图,兔,吐
酗	许,序,叙,续,蓄,须,需,徐,虚,吁,绪
援	源,员,元,愿,远,缓,原,渊,怨,圆,暖,冤,园,缘,袁,院
呵	喝,盒,合,何,贺,荷,赫,河,核,和
艾	矮,爱,碍,哎,挨,哀,埃,唉
缎	短,锻,断,段,端
垒	泪,蕾,类,勒,雷,内,累
额	恶,鹅,鄂,俄,饿
者	煮,遮,署,绪,浙,责,泽,著,赌,都,这,择,哲,诸,折,则,堵,着
影	鹰,英,映,姻,吟,赢,因,迎,殷,隐,盈,应,印,阴,引,硬,营,颖,婴,音,饮,银
盒	合,何,和,喝,猛,赫,孟,河,盆,盐,监,贺,荷,呵,核
顺	领,瞬,烦,须,孙,损,顽,页
茬	叉,插,擦,察,茶,差,查
绽	暂,账,展,粘,章,长,占,掌,涨,障,仗,张,咱,战,沾,丈,胀,赞,帐,站
喧	悬,恒,选,旋,玄,宣
您	淋,凝,磷,林,邻,宁,临
垮	刮,瓜,夸,污,寡,挂,跨
滞	字,执,肢,址,姿,致,稚,旨,志,直,滋,制,脂,织,支,汁,知,纸,指,资,兹,自,职,止,质,紫,芝,值,智,之,置,秩,治,子,至,殖,植,只,枝
乙	异,逸,役,医,抑,毅,义,一,益,议,疑,亦,姨,宜,蚁,椅,移,译,疫,谊,亿,已,衣,依,遗,矣,易,仪,以,艺,伊,意,忆,翼
华	划,话,哗,花,画,滑,化
融	绒,溶,熔,容,笼,隔,歌,哥,龙,隆,荣,拢,垄
机	基,挤,集,济,鸡,寂,脊,际,既,疾,祭,技,及,辑,吉,迹,级,急,极,积,饥,即,几,击,己,绩,肌,激,忌,计,季,继,寄,籍,剂,记,纪
井	禁,净,静,惊,金,京,敬,近,精,劲,锦,筋,镜,津,晋,境,景,竟,浸,尽,巾,经,茎,警,颈,竞,进,仅,睛,晶,紧,谨,今,径,斤
耍	女,要,刷,妥
名	命,鸣,明,民,敏
杂	咋,炸,扎
腊	猎,拉,借,哪,那,娜,拿,呐,钠,惜,辣,错,蜡,措,啦,纳
绕	老,牢,扰,捞,烧,劳,饶
断	迷,米,短,锻,段,端,继
区	取,屈,趣,驱,渠,欧,躯,去,曲,趋
挨	矮,爱,碍,哎,哀,埃,唉,艾
救	舅,究,旧,久,酒,九,纠,就
惶	荒,缓,皇,幻,煌,环,欢,黄,患,换,晃,慌,唤
水	髓,虽,税,碎,岁,睡,遂,随
哼	冯,风,狠,疯,蜂,衡,恒,锋,缝,很,峰,封,凤,奉,丰,横,恨,逢,痕
叛	判,盼,半,伴,盘,潘,庞,攀,旁,胖
插	叉,擦,察,茶,差,查
渲	悬,恒,选,旋,玄,宣
妖	腰,跃,要,耀,药,邀,遥,摇,咬,姚
然	懒,篮,烂,栏,滥,嚷,染,拦,兰,览,让,燃,蓝,壤
疫	异,逸,役,医,抑,毅,义,一,益,议,疑,亦,乙,姨,宜,蚁,椅,移,译,谊,亿,已,衣,依,遗,矣,易,仪,以,艺,伊,意,忆,翼
馏	柳,纽,流,瘤,硫,刘,牛,留,溜,扭,六
劣	裂,猎,捏,烈,咧,列
反	凡,范,泛,犯,妨,饭,板,房,寒,防,汉,仿,纺,方,罕,贩,函,烦,番,繁,返,版,翻,喊,涵,韩,放,芳,含,访,旱,汗
译	异,逸,役,医,抑,毅,义,一,益,议,疑,亦,乙,姨,宜,蚁,椅,泽,移,疫,谊,亿,已,衣,依,遗,矣,易,择,仪,以,艺,伊,意,忆,翼
疲	披,譬,匹,皮,辟,屁,脾,批
愤	喷,冯,风,狠,疯,蜂,份,锋,氛,缝,很,芬,峰,粉,封,凤,奉,丰,粪,奋,恨,逢,分,坟,纷,痕
覆	抚,扶,忽,副,服,湖,富,糊,乎,赋,复,夫,傅,妇,幅,肤,呼,父,佛,辅,伏,付,胡,符,户,互,弗,腹,赴,咐,缚,浮,府,福,履,护,虎,腐,辐,负,甫,附
陡	超,趣,越,起,趟,兜,徒,斗,抖,走,豆,趋,都
吟	鹰,英,映,姻,赢,影,因,迎,殷,隐,盈,应,印,阴,引,硬,贪,营,颖,婴,念,音,饮,银,今
嗜	市,实,司,寺,尸,四,使,拾,室,适,食,世,私,是,施,逝,势,死,识,师,石,试,诗,始,释,蚀,斯,撕,十,湿,思,式,似,士,示,氏,丝,史,事,饲,视,驶,时,饰,失
洋	群,焰,氧,鲜,阳,厌,严,言,养,验,颜,央,沿,样,宴,燕,咽,秧,扬,盐,研,眼,炎,艳,烟,延,演,杨,详,掩,衍,仰,羊,岩
肢	字,执,滞,址,姿,致,稚,旨,志,直,滋,制,脂,织,技,支,汁,知,纸,指,资,兹,自,职,鼓,止,质,歧,紫,芝,值,智,之,置,秩,治,子,至,殖,植,只,枝
庐	努,辱,录,怒,炉,儒,如,露,房,芦,入,驴,户,奴,陆,路,鲁,乳,碌,卢,鹿
肖	萧,孝,笑,校,梢,效,稍,晓,小,悄,哨,硝,销,消
徘	菲,排,匪,牌,非,悲,拍,辈,派
闪	闭,上,门,衫,赏,珊,陕,三,阔,商,散,闯,善,伤,山,扇,闷,尚,闲
物	吴,五,乌,雾,舞,屋,无,务,污,悟,午,伍,呜,武,吾,误
渗	生,审,婶,伸,升,身,绳,肾,惨,参,省,什,慎,圣,声,申,牲,神,剩,深,沈,胜,甚,盛,森
危	跪,畏,慰,委,胃,惟,威,味,围,伟,未,为,位,伪,谓,尾,卫,维,纬,微,魏,喂,脆,唯,违
耙	爸,拔,八,坝,叭,吧,霸,罢,把,巴
穴	穷,空,学,血,雪,削
阿	啊
功	宫,控,巩,工,孔,贡,弓,供,空,共,公,攻,恐,恭
丸	万,汪,往,网,湾,忘,亡,旺,完,玩,顽,望,碗,挽,晚,妄,王,弯
歹	呆,代,逮,戴,袋,带,待,贷
靖	禁,净,静,惊,金,京,敬,近,精,劲,锦,筋,镜,津,晋,境,景,竟,浸,尽,巾,经,井,茎,警,颈,竞,进,仅,睛,晶,紧,谨,今,径,斤
些	鞋,携,谢,斜,此,柴,写,协,谐,紫,械,歇,邪,卸,泄,胁
皖	万,汪,往,网,湾,忘,亡,旺,完,玩,顽,望,碗,挽,晚,妄,王,弯
咸	享,项,宪,显,乡,象,献,鲜,线,香,县,贤,想,现,翔,减,祥,箱,掀,橡,相,腺,弦,仙,嫌,响,详,险,限,先,纤,陷,喊,像,湘,向,闲
椭	托,拖,驼,脱,妥
减	碱,蒋,讲,匠,简,见,尖,箭,键,降,姜,剪,渐,奖,剑,件,健,建,江,疆,检,坚,将,兼,监,肩,鉴,间,艰,喊,舰,僵,践,奸,歼,浆
跛	披,博,剥,彼,伯,玻,拨,勃,脖,播,波,搏,被,坡,皮,驳,皱,膊,疲,破,卜
涕	体,踢,替,题,梯,提
蹭	城,曾,层,称,诚,程,呈,成,惩,撑,乘,承
缉	基,挤,集,济,鸡,寂,脊,际,机,既,疾,祭,技,及,辑,吉,迹,级,急,极,积,饥,即,几,击,己,绩,肌,激,忌,计,季,继,寄,籍,剂,记,纪
丙	饼,兵,冰,滨,并,宾,病
气	汽,期,岂,骑,凄,栖,棋,奇,齐,旗,起,其,弃,歧,器,企,漆,戚,七,契,启,妻,欺
库	姑,骨,股,故,苦,固,酷,鼓,雇,咕,孤,古,枯,谷,哭,裤,顾,估
域	与,裕,玉,育,愚,誉,语,豫,遇,雨,宇,愉,喻,于,愈,渔,预,余,予,欲,寓,郁,狱,娱,羽,舆,鱼,御,浴
悔	绘,辉,汇,毁,梅,灰,海,霉,回,慧,惠,恢,挥,徽,会,每
疤	爸,拔,八,坝,叭,吧,霸,罢,把,巴
蛮	忙,慢,曼,满,亦,盲,迹,漫,恋,变,茫
恳	坑,跟,垦,肯,恨,狼,娘,狠,根
高	搞,靠,告,考,稿
斩	暂,账,展,粘,章,长,占,掌,涨,障,渐,仗,张,咱,战,沾,丈,胀,赞,帐,站
淫	鹰,英,映,姻,吟,赢,影,因,迎,殷,隐,盈,应,印,阴,引,硬,营,颖,婴,音,饮,银
蚊	温,吻,翁,文,纹,稳,问,闻
北	贝,杯,卑,背,悲,碑,备,被,辈,倍
陌	怕,默,伯,莫,拍,泊,漠,柏,帕,摸,沫,白,膜,摩,末,墨,魔,抹,模,磨
如	辱,录,炉,儒,露,芦,入,陆,路,鲁,乳,碌,卢,鹿
镰	梁,凉,谅,良,链,辆,恋,亮,连,练,炼,联,两,怜,廉,粮,念,莲,年,量,帘,脸
拥	泳,庸,用,涌,永,勇
犯	凡,范,泛,妨,饭,房,寒,反,防,汉,仿,纺,方,罕,贩,函,烦,番,繁,返,翻,喊,涵,韩,放,芳,含,访,旱,汗
准	维,尊,堆,住,推,遵
磁	词,次,池,齿,瓷,刺,持,滋,驰,此,辞,耻,兹,斥,尺,迟,慈,吃,翅,雌,赤
哑	芽,押,雅,压,鸦,鸭,崖,牙,呀,亚
查	叉,插,擦,察,茶,差
鼠	诉,疏,束,数,蔬,淑,署,树,叔,宿,枢,肃,输,术,属,抒,俗,素,书,熟,舒,速,苏,塑,述,竖,殊
掺	渗,阐,苍,藏,缠,惨,参,残,仓,蚕,禅,颤,舱,餐,产
拧	龄,铃,另,您,陵,灵,玲,凝,零,领,令,凌,岭,宁
耀	姚,咬,摇,腰,邀,要,药,遥
伐	罚,哈,阀,乏,法,发
盯	顶,打,丁,叮,钉,定,订
快	缺,块,拐,决,怪
萧	效,硝,销,孝,消,笑,晓,校,小,肖
映	鹰,英,姻,吟,赢,影,因,迎,殷,隐,盈,央,应,印,阴,秧,引,硬,营,颖,婴,音,饮,银
寻	训,讯,旬,扫,迅,询,逊,循,雪,灵,巡
湿	市,实,司,寺,尸,四,使,拾,室,适,食,世,私,是,施,逝,势,死,识,师,石,试,诗,始,释,蚀,斯,撕,十,思,式,似,士,示,氏,丝,史,事,饲,视,驶,时,饰,失
校	胶,萧,孝,笑,郊,效,效,晓,小,肖,交,咬,硝,销,消
扰	老,牢,捞,劳,饶,绕
颖	鹰,英,映,姻,吟,赢,影,因,迎,殷,隐,盈,应,印,阴,引,硬,营,婴,音,饮,银
桶	筒,痛,童,涌,通,统,铜,同
纹	温,吻,翁,文,稳,问,闻
袄	傲,奥,跃,澳,凹
幻	荒,缓,皇,惶,煌,环,欢,黄,患,换,晃,慌,唤
碱	蒋,讲,匠,简,见,减,尖,箭,键,降,姜,剪,渐,奖,剑,件,健,建,江,疆,检,坚,将,兼,监,肩,鉴,间,艰,舰,僵,践,奸,歼,浆
撤	测,策,朝,彻,车,扯,册,侧,潮
匠	碱,蒋,讲,简,见,减,尖,箭,键,降,姜,剪,渐,奖,剑,件,健,建,江,疆,检,坚,将,兼,监,肩,鉴,间,艰,舰,僵,践,奸,歼,浆
距	巨,惧,拒,聚,俱,举,居,据,剧,柜,菊,局,矩,拘,句,具
怕	陌,白,拍,爬,伯,泊,柏,帕
禾	喝,盒,合,何,贺,荷,赫,呵,河,核,和
核	喝,盒,合,何,贺,荷,赫,该,呵,河,咳,刻,和
隙	晰,戏,袭,析,悉,稀,习,吸,希,席,西,嘻,锡,细,夕,息,溪,牺,系,惜,洗,喜,媳
村	过,醇,唇,春,栖,材,衬,存,纯,付,寸,守,框,讨,林,对,木,时
萨	沙,纱,刹,洒,杀,啥,撒,厦,砂,傻
撼	凡,含,范,杭,泛,犯,饭,寒,反,汉,航,贩,罕,烦,番,繁,返,翻,喊,涵,韩,函,旱,汗
茎	禁,净,静,惊,金,京,敬,近,精,劲,锦,筋,镜,津,晋,境,景,竟,浸,尽,巾,经,井,警,颈,竞,进,仅,睛,晶,紧,谨,今,径,斤
芋	与,裕,玉,育,愚,誉,语,豫,遇,雨,宇,愉,喻,于,愈,渔,预,余,予,欲,寓,域,郁,狱,娱,羽,舆,鱼,御,浴
不	布,环,步,坏,补,捕,部
揭	借,界,喝,介,截,街,渴,姐,皆,劫,捷,戒,届,杰,接,洁,竭,阶,节,结,解
愚	与,裕,玉,育,誉,语,豫,遇,雨,宇,愉,喻,于,愈,渔,预,余,予,欲,寓,域,郁,狱,娱,羽,舆,鱼,御,浴
奠	垫,典,淀,电,殿,店,点,颠
劳	老,闹,牢,扰,捞,脑,恼,饶,绕
渔	与,裕,玉,育,愚,誉,语,豫,遇,雨,宇,愉,喻,于,愈,预,余,予,欲,寓,域,郁,狱,娱,羽,舆,鱼,御,浴
曼	忙,蛮,漫,茫,慢,盲,满
漆	汽,期,岂,骑,凄,栖,棋,气,奇,齐,旗,起,其,弃,歧,器,企,戚,七,契,启,妻,欺
两	梁,凉,谅,娘,良,链,辆,恋,亮,连,练,炼,联,怜,廉,粮,莲,量,帘,脸
梳	诉,疏,束,数,蔬,淑,署,树,叔,宿,枢,肃,输,术,属,抒,俗,素,书,鼠,熟,舒,速,苏,塑,述,竖,殊
揍	奏,州,凑,宙,昼,洲,走,轴,皱,骤,周
涛	陶,萄,桃,铸,筹,讨,寿,淘,套,逃,掏
眼	焰,氧,阳,厌,严,言,养,验,颜,洋,央,沿,样,宴,燕,咽,秧,扬,盐,研,炎,艳,烟,延,演,杨,掩,衍,仰,羊,岩
苇	畏,慰,委,胃,惟,威,味,围,危,伟,韦,未,为,位,伪,谓,尾,卫,维,纬,微,魏,喂,唯,违
拔	爸,八,坝,叭,吧,霸,罢,把,巴
迈	卖,埋,麦,买,脉
势	市,实,司,寺,尸,四,使,拾,室,适,食,世,私,是,施,逝,死,识,师,石,试,诗,始,释,蚀,斯,撕,十,湿,思,式,似,士,示,氏,丝,史,事,饲,视,驶,时,饰,失
朱	阻,柱,煮,驻,租,贮,嘱,主,祝,助,筑,珠,足,住,竹,铸,逐,组,祖,诸,猪,株,族,注
瘸	缺,雀,确,却
复	抚,扶,忽,副,服,湖,富,糊,乎,赋,夫,傅,妇,覆,幅,肤,呼,父,佛,辅,伏,付,胡,符,户,互,弗,腹,赴,咐,缚,浮,府,福,履,护,虎,腐,辐,负,甫,附
根	跟,垦,耕,肯,更,恳
鼻	闭,笔,比,彼,逼,毕,壁,蔽,碧,必,币,弊,避,臂
何	喝,盒,合,贺,荷,赫,呵,河,核,和
的	地,约,得,德
穆	亩,木,牧,姆,墓,幕,慕,目,母
细	晰,戏,袭,析,悉,稀,习,吸,希,席,西,嘻,锡,隙,夕,息,溪,牺,系,惜,洗,喜,媳
打	答,丁,叮,搭,盯,钉,达,订,大
负	抚,扶,忽,副,服,湖,富,糊,账,乎,赋,贫,复,夫,傅,妇,覆,幅,肤,呼,父,佛,辅,责,伏,付,胡,符,货,户,互,弗,贪,腹,财,赴,咐,缚,浮,贝,府,福,护,虎,腐,贺,辐,甫,附
哭	姑,骨,股,故,苦,固,酷,鼓,雇,咕,库,孤,古,枯,谷,裤,顾,估
报	堡,薄,爆,饱,包,保,胞,抱,暴,宝
性	生,醒,行,杏,兴,新,信,幸,欣,型,辛,心,姓,形,星,刑
躏	淋,龄,铃,另,您,磷,邻,陵,灵,玲,林,零,临,领,令,凌,岭
吸	晰,戏,袭,析,悉,稀,习,希,席,及,西,嘻,锡,细,级,隙,夕,极,息,溪,牺,系,惜,洗,喜,媳
及	基,挤,集,济,鸡,寂,脊,际,机,既,疾,祭,技,吸,辑,吉,迹,级,急,极,积,饥,即,几,击,己,绩,肌,激,忌,计,季,继,寄,籍,剂,记,纪
糕	高,搞,靠,告,考,稿
念	娘,吟,链,恋,连,练,今,贪,炼,联,怜,廉,莲,年,帘,脸
睫	借,界,介,截,街,姐,皆,劫,捷,戒,届,杰,接,洁,竭,阶,节,结,解,揭
决	缺,掘,块,快,觉,绝
阴	鹰,英,映,姻,吟,赢,影,因,迎,殷,隐,盈,应,印,引,硬,营,颖,婴,音,饮,银
殷	鹰,英,映,姻,吟,赢,影,因,迎,隐,盈,应,印,阴,引,硬,营,颖,婴,音,饮,银
怨	源,员,元,愿,远,原,渊,圆,援,冤,园,缘,袁,院
粤	曰,越,岳,约,悦,跃,月,阅
信	醒,行,杏,兴,新,幸,欣,性,型,辛,心,姓,形,星,刑
借	猎,界,腊,介,截,街,姐,皆,劫,捷,惜,戒,届,杰,接,错,蜡,措,洁,竭,阶,节,结,解,揭
咨	次,字,执,肢,滞,址,姿,致,稚,旨,志,直,滋,制,脂,织,支,汁,知,纸,指,资,兹,自,职,止,质,紫,芝,值,智,之,置,秩,治,子,至,殖,植,只,枝
萝	逻,弱,诺,螺,若,络,落,裸,洛,罗
兽	收,搜,瘦,售,受,守,首,寿,手,授
榄	懒,郎,篮,然,南,烂,难,栏,滥,染,浪,拦,兰,廊,览,燃,蓝,男,朗,狼
炭	坦,滩,躺,谈,倘,堂,灰,碳,糖,探,贪,坛,塘,恢,汤,唐,趟,叹,摊
颗	葛,格,隔,课,个,歌,棵,哥,可,革,胳,壳,阁,克,各,果,科,割,渴,客,鸽,刻,戈
虫	匆,从,聪,冲,蚕,崇,独,充,丛,蛋
用	泳,庸,涌,拥,永,勇
劲	禁,净,静,惊,金,京,敬,近,精,锦,筋,镜,津,晋,境,景,竟,浸,尽,巾,经,井,茎,警,颈,竞,进,仅,睛,晶,紧,谨,今,径,斤
侦	诊,争,整,珍,症,振,政,怎,挣,证,睁,镇,阵,郑,真,针,蒸,震,贞,正,征
刊	看,干,康,感,堪,甘,肝,赶,坎,敢,抗,杆,砍,炕
拒	巨,距,惧,聚,俱,举,居,据,剧,柜,菊,局,矩,拘,句,具
冉	懒,篮,然,烂,栏,滥,嚷,染,拦,兰,览,让,燃,蓝,壤
裙	群,君
凳	灯,瞪,登,等,邓
置	字,执,肢,滞,址,姿,致,稚,旨,志,直,滋,制,脂,织,支,汁,知,纸,指,资,兹,自,职,止,质,紫,芝,值,智,之,秩,治,子,至,殖,植,只,枝
柳	纽,流,瘤,硫,刘,牛,留,溜,扭,六
怡	异,逸,役,医,抑,毅,义,一,益,议,疑,亦,乙,姨,宜,蚁,椅,移,译,疫,谊,亿,已,衣,依,遗,矣,易,仪,以,艺,伊,意,忆,翼
纬	畏,慰,委,胃,惟,威,味,围,危,伟,韦,未,为,位,伪,谓,尾,卫,维,微,魏,喂,唯,违
应	鹰,英,映,姻,吟,赢,影,因,迎,殷,隐,盈,印,阴,引,硬,营,颖,婴,音,饮,银
争	诊,整,珍,症,振,政,侦,挣,证,睁,镇,增,阵,郑,真,针,蒸,震,贞,正,征
临	淋,龄,篮,铃,另,您,磷,邻,陵,灵,玲,林,零,领,蓝,监,令,鉴,凌,岭
国	括,扩,过,郭,锅,裹,果,阔
杠	干,港,康,感,甘,肝,赶,敢,岗,刚,纲,抗,杆,钢,炕
明	命,鸣,民,名,敏
挽	逸,万,汪,往,网,湾,忘,亡,勉,旺,完,玩,免,顽,望,碗,晚,妄,王,弯
晶	禁,净,静,惊,金,京,敬,近,精,劲,锦,筋,镜,津,晋,境,景,竟,浸,尽,巾,经,井,茎,警,颈,竞,进,仅,睛,紧,谨,今,径,斤
妄	万,汪,往,网,湾,忘,亡,旺,完,玩,顽,望,碗,挽,晚,王,弯
滨	饼,兵,冰,并,丙,宾,病
烤	高,煤,搞,靠,告,考,稿,烧,灾,炎,火
咒	奏,州,宙,昼,洲,走,轴,皱,骤,周
须	序,吁,需,顺,绪,许,叙,徐,页,蓄,烦,顽,领,续,虚
尔	耳,而,儿,弥,你,二
陪	胚,培,配,佩,赔,倍,部
帮	榜,斑,板,邦,膀,半,傍,伴,班,棒,搬,扮,办,版,颁,般
官	广,贯,馆,惯,灌,宽,罐,观,冠,管,关,光,款
费	菲,黑,匪,肥,肺,非,嘿,废,飞,沸
鬼	规,跪,愧,桂,贵,硅,轨,亏,龟,魂,柜,归,魏,溃
垢	扣,钩,狗,够,口,构,沟,购,勾
箕	基,挤,集,济,鸡,寂,脊,际,机,既,疾,祭,技,及,辑,吉,迹,级,急,极,积,饥,即,几,击,己,绩,肌,激,忌,计,季,继,寄,籍,剂,记,纪
演	焰,氧,阳,厌,严,言,养,验,颜,洋,央,沿,样,宴,燕,咽,秧,扬,盐,研,眼,炎,艳,烟,延,杨,掩,衍,仰,羊,岩
晌	上,衫,赏,珊,陕,商,丧,善,伤,闪,山,响,嗓,扇,桑,尚,向
狼	懒,郎,篮,娘,狠,烂,恳,良,栏,滥,嚷,囊,垦,浪,拦,兰,廊,览,让,蓝,恨,朗,壤
玲	淋,龄,冷,铃,另,磷,邻,陵,灵,凝,林,零,临,怜,领,令,凌,岭,宁
宫	控,贡,功,巩,工,共,恭,铝,吕,攻,恐,孔,弓,供,空,公
恃	市,实,司,寺,尸,四,使,拾,室,适,食,世,私,是,施,逝,势,死,识,师,石,试,诗,始,释,蚀,斯,撕,十,湿,思,式,似,士,示,氏,丝,史,事,饲,视,驶,时,饰,失
凭	频,苹,品,平,拼,屏,瓶,萍,贫,评
跪	规,鬼,愧,危,桂,贵,硅,轨,亏,龟,柜,归,脆,溃
誊	藤,誉,倦,疼,券,卷,腾
绷	奔,笨,本
幼	优,犹,幽,游,由,又,悠,忧,有,诱,油,右,邮,友,尤
屁	披,譬,匹,皮,辟,疲,脾,批
讯	训,旬,寻,迅,询,逊,循,巡
服	抚,扶,忽,副,湖,富,糊,乎,赋,复,夫,傅,妇,覆,幅,肤,呼,父,佛,辅,伏,付,胡,符,户,互,弗,腹,赴,咐,缚,浮,府,福,护,虎,腐,辐,负,甫,附
塘	坦,滩,躺,谈,倘,堂,碳,糖,炭,探,贪,坛,汤,唐,趟,叹,摊
冗	绒,溶,熔,拢,容,笼,融,龙,隆,荣,垄
窿	农,绒,溶,熔,容,笼,浓,融,龙,隆,荣,拢,垄,弄
怜	龄,梁,凉,谅,冷,铃,良,链,邻,辆,玲,恋,亮,连,练,炼,联,两,廉,粮,领,念,令,岭,莲,年,量,帘,脸
台	太,抬,泰,胎,态
淘	陶,涛,萄,桃,讨,套,逃,掏
昆	困,棍,滚
油	优,犹,抽,幽,游,由,又,庙,悠,忧,有,诱,袖,右,邮,迪,幼,友,尤
许	序,叙,续,蓄,须,需,徐,虚,吁,绪
畜	础,储,粗,初,出,楚,促,触,厨,处,除
扁	变,遍,辩,编,辨,鞭,篇,骗,便,边,偏
涤	底,帝,弟,递,低,抵,蒂,第,滴,迪,堤,敌
痰	坦,滩,躺,谈,倘,堂,碳,糖,炭,探,贪,坛,塘,汤,唐,趟,叹,摊
菌	峻,军,俊,君,均
袭	晰,戏,析,悉,稀,习,吸,希,席,西,嘻,锡,细,隙,夕,息,溪,牺,系,惜,洗,喜,媳
悖	贝,杯,卑,北,背,悲,碑,备,被,辈,倍
鸦	芽,押,雅,压,哑,鸭,崖,牙,呀,亚
娜	钠,辣,拉,蜡,拿,哪,啦,那,呐,纳,腊
电	奠,垫,典,淀,殿,店,点,颠
铭	命,鸣,明,民,名,敏
虐	掠,略
郑	诊,争,整,珍,症,振,政,侦,挣,证,睁,镇,增,阵,真,针,蒸,震,贞,正,征
墙	前,千,强,潜,迁,钱,歉,谦,遣,欠,腔,签,抢,浅,铅,牵,枪
赴	抚,扶,忽,副,服,湖,富,糊,乎,赋,复,夫,傅,妇,覆,幅,肤,呼,父,佛,辅,伏,付,胡,符,户,互,弗,腹,咐,缚,浮,府,福,护,虎,腐,辐,负,甫,附
鞍	暗,氨,岸,俺,案,按,昂,安
苑	源,员,元,愿,远,原,渊,怨,圆,援,冤,园,缘,袁,院
终	忠,仲,纵,众,重,总,宗,种,综,钟,衷,中,踪,肿
攻	功,宫,控,巩,工,孔,贡,弓,供,空,共,公,恐,恭
宙	奏,州,昼,洲,走,轴,皱,骤,周
节	借,界,介,截,街,姐,皆,劫,捷,戒,届,杰,接,洁,竭,阶,结,解,揭
猛	监,蒙,萌,盒,盐,门,们,梦,盟,闷,孟,盆
垫	奠,典,淀,电,殿,店,点,颠
漾	焰,氧,阳,厌,严,言,养,验,颜,洋,央,沿,样,宴,燕,咽,秧,扬,盐,研,眼,炎,艳,烟,延,演,杨,掩,衍,仰,羊,岩
四	市,实,司,寺,尸,使,拾,室,适,食,世,私,是,施,逝,势,死,识,师,石,试,诗,始,释,蚀,斯,撕,十,湿,思,式,似,士,示,氏,丝,史,事,饲,视,驶,时,饰,失
琅	懒,郎,篮,烂,栏,滥,嚷,囊,浪,拦,兰,廊,览,让,蓝,朗,狼,壤
拱	控,贡,功,宫,巩,工,共,恭,洪,攻,恐,哄,孔,弓,供,空,公
尉	畏,慰,委,胃,惟,威,味,围,危,伟,未,为,位,伪,谓,尾,卫,维,纬,微,魏,喂,唯,违
芥	借,界,介,截,街,姐,皆,劫,捷,戒,届,杰,接,洁,竭,阶,节,结,解,揭
堡	报,薄,爆,饱,包,保,胞,抱,暴,宝
冒	茅,貌,帽,毛,茂,贸,猫,矛
抑	异,逸,役,医,毅,义,一,益,议,疑,亦,乙,姨,宜,蚁,椅,移,译,疫,谊,亿,已,衣,依,遗,矣,易,仪,以,艺,伊,意,忆,翼
抽	凑,仇,愁,筹,由,袖,臭,丑,油,瞅,酬,邮,迪,庙,畴
勇	泳,庸,用,涌,拥,永
仙	享,项,宪,显,乡,象,献,鲜,线,香,县,贤,想,现,翔,祥,箱,掀,橡,相,腺,弦,嫌,响,详,险,限,先,纤,陷,像,湘,向,闲
蚂	马,嘛,吗,麻,妈,码,玛,骂
惯	广,贯,馆,灌,宽,官,罐,观,冠,管,关,光,款
逻	弱,诺,螺,萝,若,络,落,裸,洛,罗
屑	鞋,写,些,协,卸,斜,谐,携,械,歇,泄,胁,邪,谢
含	凡,范,杭,泛,犯,饭,寒,反,汉,航,贩,罕,烦,番,繁,返,翻,喊,涵,韩,函,旱,汗
倾	轻,庆,琴,侵,晴,请,清,氢,亲,青,情,勤,秦
栈	暂,账,展,粘,章,长,占,掌,涨,障,仗,张,咱,战,沾,丈,胀,赞,帐,站
实	市,司,寺,尸,四,使,拾,室,适,食,世,私,是,施,逝,势,死,识,师,石,试,诗,始,释,蚀,斯,撕,十,湿,思,式,似,士,示,氏,丝,史,事,饲,视,驶,时,饰,失
飘	疯,票,漂,风
杰	借,界,介,截,街,姐,皆,劫,捷,戒,届,接,洁,竭,阶,节,结,解,揭
勾	扣,钩,狗,够,口,构,沟,购
悦	曰,越,岳,说,约,脱,跃,月,阅
扑	铺,葡,仆,朴,补,谱,普,卜
氮	胆,单,弹,丹,党,但,当,旦,诞,荡,档,淡,挡,蛋,担
枫	冯,风,疯,蜂,份,衡,恒,氛,锋,缝,芬,峰,粉,封,凤,奉,丰,粪,横,奋,哼,飘,逢,分,坟,纷,愤
尧	腰,饶,烧,要,耀,药,邀,遥,摇,绕,咬,姚
探	坦,滩,躺,谈,倘,堂,碳,糖,炭,贪,坛,塘,汤,唐,趟,叹,摊
糊	抚,扶,忽,副,服,湖,富,乎,赋,复,夫,傅,妇,覆,幅,肤,呼,父,佛,辅,伏,付,胡,符,户,互,弗,腹,赴,咐,缚,浮,府,福,护,虎,腐,辐,负,甫,附
被	披,彼,玻,波,卑,北,悲,碑,辈,倍,坡,杯,皮,皱,贝,疲,背,破,备
衬	过,尘,称,程,沉,惩,城,诚,村,臣,付,承,寸,守,呈,讨,趁,对,陈,时,成,晨,撑,乘
视	市,实,司,寺,尸,四,使,拾,室,适,觉,食,世,私,现,见,是,施,逝,势,死,识,师,石,试,诗,始,释,蚀,斯,撕,十,湿,思,式,似,士,示,观,氏,丝,史,事,饲,驶,时,饰,失
鸡	基,挤,集,济,寂,脊,际,机,既,疾,祭,技,及,辑,吉,迹,级,急,极,积,饥,即,几,击,己,绩,肌,激,忌,计,季,继,寄,籍,剂,记,纪
宾	饼,兵,冰,滨,并,丙,病
坚	碱,蒋,讲,匠,简,见,减,尖,箭,键,降,姜,剪,渐,奖,剑,件,健,建,江,疆,检,将,兼,监,肩,鉴,间,艰,舰,僵,践,奸,歼,浆
丛	匆,从,聪,纵,冲,众,崇,充,虫
幸	醒,行,杏,兴,新,信,欣,性,型,辛,心,姓,形,星,刑
劝	权,拳,圈,全,泉,券
材	才,栖,采,村,柴,裁,蔡,框,财,林,猜,拆,彩,菜,木
曰	越,岳,约,悦,跃,月,阅
盗	倒,岛,稻,导,蹈,刀,到,道
是	市,实,司,寺,尸,四,使,拾,室,适,食,世,提,私,施,逝,势,死,识,师,石,试,诗,始,释,蚀,斯,撕,十,湿,思,式,似,题,士,示,堤,氏,丝,史,事,饲,视,驶,时,饰,失
里	逆,黎,厉,梨,理,李,利,立,离,童,礼,吏,厘,莉,历,埋,著,哩,隶,你,丽,拟,尼,励,力,泥,日,例,粒,璃
巾	禁,净,静,惊,金,京,敬,近,精,劲,锦,筋,镜,津,晋,境,景,竟,浸,尽,经,井,茎,警,颈,竞,进,仅,睛,晶,紧,谨,今,径,斤
佑	游,友,优,由,又,邮,犹,油,幽,悠,右,忧,有,诱,幼,尤
沫	墨,陌,魔,莫,默,抹,模,漠,膜,摸,磨,摩,末
速	诉,疏,束,数,蔬,淑,署,树,叔,宿,枢,肃,输,术,属,抒,俗,素,书,鼠,熟,舒,苏,塑,述,竖,殊
谢	鞋,写,些,协,卸,斜,谐,携,械,歇,泄,胁,邪
朦	蒙,萌,猛,门,们,梦,盟,闷,孟
跟	垦,耕,肯,更,根,恳
汉	凡,含,范,杭,泛,犯,饭,寒,反,航,贩,罕,烦,番,繁,返,翻,喊,涵,韩,函,旱,汗
扇	上,衫,赏,珊,陕,三,商,散,善,伤,闪,山,尚
鄂	恶,鹅,俄,饿,额
睁	诊,争,整,珍,症,振,政,侦,挣,证,镇,增,阵,郑,真,针,蒸,震,贞,正,征
帜	字,执,肢,滞,址,姿,致,稚,旨,志,直,滋,制,脂,织,支,汁,知,纸,识,指,资,兹,自,职,止,质,紫,芝,值,智,之,置,秩,治,子,至,殖,植,只,枝
尖	碱,蒋,讲,匠,简,见,减,箭,键,降,姜,剪,渐,奖,剑,件,健,建,江,疆,检,坚,将,兼,监,肩,鉴,间,艰,舰,僵,践,奸,歼,浆
汰	台,太,抬,泰,胎,态
悄	敲,瞧,桥,梢,稍,巧,肖,乔,哨,侨,销,硝,消
蝗	荒,缓,皇,惶,幻,煌,环,欢,黄,患,换,晃,慌,唤
彤	筒,痛,童,桶,通,统,铜,同
斌	饼,兵,冰,滨,并,丙,宾,病
揉	柔,楼,肉,漏
权	拳,圈,又,全,劝,泉,券
培	胚,配,佩,赔,陪
瘪	别
惩	尘,称,程,沉,症,城,层,证,诚,衬,歪,臣,承,呈,趁,曾,正,征,陈,成,晨,撑,乘
想	享,项,宪,显,乡,象,献,鲜,线,香,县,贤,现,翔,祥,箱,掀,橡,相,腺,弦,仙,嫌,响,详,险,限,先,纤,陷,像,湘,向,闲
取	屈,趣,驱,渠,躯,区,去,曲,趋
在	摘,窄,寨,宰,再,灾,载,宅,债,仔,栽
着	这,择,哲,浙,著,折,者,遮,责,则,泽
啤	披,譬,匹,皮,辟,疲,屁,脾,批
褂	刮,瓜,夸,寡,挂,跨
总	忠,仲,纵,终,众,重,宗,种,综,钟,衷,中,踪,肿
唐	坦,滩,躺,谈,倘,堂,碳,糖,炭,探,贪,坛,塘,汤,趟,叹,摊
嘲	巢,超,操,朝,抄,曹,槽,撤,吵,草,潮
膜	墨,陌,魔,莫,默,抹,模,漠,摸,磨,摩,末,沫
撑	尘,称,程,沉,惩,城,层,诚,衬,臣,承,呈,趁,曾,陈,成,晨,乘
勋	训,讯,旬,寻,迅,询,逊,循,巡
鞋	写,些,协,卸,斜,谐,携,械,歇,泄,胁,邪,谢
稍	嫂,绍,梢,烧,肖,悄,哨,扫,销,少,硝,消
撵	娘,链,恋,连,练,炼,联,怜,廉,念,莲,年,帘,脸
藉	基,挤,集,济,鸡,寂,脊,际,机,既,疾,祭,技,及,辑,吉,迹,级,急,极,积,饥,即,几,击,己,绩,肌,激,忌,计,季,继,寄,籍,剂,记,纪
租	阻,柱,煮,驻,贮,嘱,主,祝,助,筑,珠,足,住,竹,铸,逐,组,祖,诸,猪,朱,株,族,注
盔	规,跪,鬼,愧,桂,贵,硅,轨,亏,龟,柜,归,溃
温	吻,翁,文,纹,稳,问,闻
熔	绒,溶,拢,容,笼,融,龙,隆,荣,垄
肥	菲,黑,匪,肺,非,嘿,废,费,飞,沸
付	抚,扶,忽,副,服,湖,富,糊,过,乎,赋,复,夫,傅,妇,覆,幅,肤,呼,父,村,衬,佛,辅,伏,胡,符,寸,户,互,弗,守,腹,讨,赴,咐,缚,浮,对,府,福,护,虎,腐,辐,时,负,甫,附
恍	荒,缓,皇,惶,幻,煌,环,欢,黄,患,换,晃,慌,唤
疮	川,穿,船,闯,创,床,串,窗,传,喘
棕	忠,仲,纵,终,众,重,总,崇,宗,种,综,钟,衷,中,踪,肿
面	勉,棉,免,绵,眠
擂	泪,蕾,类,勒,雷,内,累
柒	汽,期,岂,骑,凄,栖,棋,气,奇,齐,旗,起,其,弃,歧,器,企,漆,戚,七,契,启,妻,欺
拌	判,榜,斑,板,邦,膀,半,傍,伴,帮,班,棒,搬,扮,办,叛,版,颁,般
仔	摘,窄,寨,宰,再,灾,在,载,宅,债,栽
摘	窄,寨,宰,再,灾,在,载,宅,债,仔,栽
患	荒,缓,皇,惶,串,幻,煌,环,欢,黄,换,晃,慌,唤
哎	矮,爱,碍,挨,哀,埃,唉,艾
类	泪,蕾,勒,雷,内,累
跃	曰,越,岳,约,悦,月,阅
僻	披,譬,匹,皮,辟,疲,屁,脾,批
叉	插,擦,察,茶,差,查
偷	愉,喻,投,透,愈,头,输
饱	保,胞,暴,包,炮,宝,堡,泡,抱,薄,爆,报,跑
亿	异,逸,役,医,抑,毅,义,一,益,议,疑,亦,乙,姨,宜,蚁,椅,移,译,疫,谊,已,衣,依,遗,矣,易,仪,以,艺,伊,意,忆,翼
由	优,犹,抽,幽,游,又,庙,悠,忧,有,诱,袖,油,右,邮,迪,幼,友,尤
呆	代,逮,戴,袋,带,待,贷
腐	抚,扶,忽,副,服,湖,富,糊,乎,赋,复,夫,傅,妇,覆,幅,肤,呼,父,佛,辅,伏,付,胡,符,户,互,弗,腹,赴,咐,缚,浮,府,福,护,虎,辐,负,甫,附
拭	市,实,司,寺,尸,四,使,拾,室,适,食,世,私,是,施,逝,势,死,识,师,石,试,诗,始,释,蚀,斯,撕,十,湿,思,式,似,士,示,氏,丝,史,事,饲,视,驶,时,饰,失
极	基,挤,集,济,鸡,寂,脊,际,机,既,疾,祭,技,吸,及,辑,吉,迹,级,急,积,饥,即,几,击,己,绩,肌,激,忌,计,季,继,寄,籍,剂,记,纪
吹	饮,坎,摧,垂,脆,锤,催,粹,欢,崔,欠,翠
渴	葛,格,隔,课,个,歌,棵,哥,可,革,胳,壳,喝,阁,克,各,科,割,客,鸽,颗,刻,戈,竭,揭
几	基,挤,集,济,鸡,寂,脊,际,机,既,疾,祭,技,及,辑,吉,迹,凯,级,急,极,积,饥,即,击,己,绩,肌,激,忌,计,季,继,寄,籍,剂,记,纪
肝	杠,看,干,港,感,甘,堪,赶,坎,敢,刊,岗,刚,纲,杆,砍,钢
作	卓,桌,炸,捉,做,左,昨,座,坐
拯	诊,争,整,珍,症,振,政,侦,挣,证,睁,镇,增,阵,郑,真,针,蒸,震,贞,正,征
设	社,涉,股,没,色,投,舍,役,摄,蛇,射,舌,般
神	生,审,渗,婶,伸,升,身,绳,肾,省,什,慎,圣,声,申,牲,剩,深,沈,胜,甚,盛,森
德	地,的,得
纫	忍,仁,任,认,仍,扔,人
栓	酸,霜,爽,双,算
识	市,实,司,寺,尸,四,使,拾,室,适,食,世,私,是,织,施,逝,势,死,师,石,试,诗,始,释,蚀,斯,撕,十,湿,思,职,式,似,士,示,氏,丝,史,事,饲,视,驶,时,饰,只,失
鸳	源,员,元,愿,远,原,渊,怨,圆,援,冤,园,缘,袁,院
袜	娃,哇,挖,瓦,蛙
纷	冯,风,狠,疯,蜂,份,锋,氛,缝,很,芬,峰,粉,封,凤,奉,丰,粪,奋,恨,愤,逢,分,坟,痕
寡	刮,瓜,夸,挂,跨
钟	忠,仲,纵,终,众,重,总,宗,种,综,衷,中,踪,肿
白	摆,仓,拜,怕,陌,抢,柏,败,拍,百,伯,泊,帕,枪
唇	寸,震,辱,振,村,存,醇,晨,纯,春
鱼	与,裕,玉,育,愚,誉,语,豫,鲜,遇,雨,宇,愉,喻,于,愈,渔,预,余,予,欲,寓,域,郁,狱,娱,羽,舆,御,浴
洪	鸿,轰,哄,红,宏,共
爱	矮,碍,哎,挨,哀,埃,唉,艾
植	字,执,肢,滞,址,姿,致,稚,旨,志,直,滋,制,脂,织,支,汁,知,纸,指,资,兹,自,职,止,质,紫,芝,值,智,之,置,秩,治,子,至,殖,只,枝
塔	她,它,拓,他,踏
勃	玻,拨,脖,博,播,膊,波,剥,驳,搏,伯,卜
钾	驾,夹,架,家,嫁,佳,甲,假,加,嘉,贾,稼,价
羊	群,焰,氧,鲜,阳,厌,严,言,养,验,颜,洋,央,沿,样,宴,燕,咽,秧,扬,盐,研,眼,炎,艳,烟,延,演,杨,详,掩,衍,仰,岩
俄	恶,鹅,鄂,饿,额
败	摆,拜,白,柏,百
贮	阻,柱,煮,驻,租,嘱,主,祝,助,筑,珠,足,住,竹,铸,逐,组,祖,诸,猪,朱,株,族,注
览	懒,郎,篮,然,南,烂,难,栏,滥,染,浪,拦,兰,廊,燃,蓝,男,朗,狼
昧	没,美,妹,梅,枚,煤,每,霉,眉,媒
磷	淋,龄,铃,另,您,邻,陵,灵,玲,林,零,临,领,令,凌,岭
惟	畏,慰,委,胃,威,味,围,危,伟,未,为,位,伪,谓,尾,卫,维,纬,微,魏,喂,唯,违
啪	怕,爬,帕
娘	梁,凉,谅,狠,恳,良,垦,辆,亮,两,粮,念,恨,年,量,狼
序	许,叙,续,蓄,须,需,徐,虚,吁,绪
孔	功,宫,控,巩,工,贡,弓,供,空,共,公,攻,恐,恭
币	闭,笔,比,彼,逼,毕,壁,蔽,鼻,碧,必,弊,避,臂
见	碱,觉,蒋,讲,匠,现,简,减,尖,箭,键,降,姜,剪,渐,奖,剑,件,健,建,江,疆,检,坚,观,将,兼,监,肩,鉴,间,艰,视,舰,僵,践,奸,歼,浆
绩	基,挤,集,济,鸡,寂,脊,际,机,既,疾,祭,技,及,辑,吉,迹,级,急,极,积,饥,即,几,击,己,肌,激,忌,计,季,继,寄,籍,剂,记,纪
绢	捐,倦,卷
士	市,实,司,寺,尸,四,使,拾,室,适,食,世,私,是,施,逝,势,死,识,师,石,试,诗,始,释,蚀,斯,撕,十,湿,思,式,似,示,氏,丝,史,事,饲,视,驶,时,饰,失
灵	淋,龄,铃,另,磷,邻,陵,玲,凝,林,零,临,领,扫,令,寻,凌,岭,宁,雪
职	字,执,肢,滞,址,姿,致,稚,旨,志,直,滋,制,脂,织,支,耸,汁,知,纸,耻,识,指,资,兹,自,止,质,紫,联,芝,值,智,之,耳,置,秩,治,子,至,殖,植,只,枝
诈	作,咋,炸,杂,昨,扎
啰	逻,弱,诺,螺,萝,若,络,落,裸,洛,罗
嘱	阻,柱,煮,驻,租,贮,主,祝,助,筑,珠,足,住,竹,铸,逐,组,祖,诸,猪,朱,株,族,注
蔓	忙,蛮,漫,茫,慢,曼,盲,满
伦	论,轮,润
篱	逆,黎,厉,梨,理,李,利,立,离,礼,吏,厘,莉,历,哩,隶,你,丽,拟,尼,励,力,里,泥,日,例,粒,璃
猫	苗,描,茅,貌,帽,冒,毛,茂,贸,矛
毒	渡,杜,督,赌,独,堵,读,肚,度
烛	阻,柱,煮,驻,租,贮,嘱,主,祝,助,筑,珠,足,住,竹,铸,逐,组,祖,诸,猪,朱,株,族,注
摄	社,涉,设,色,舍,蛇,射,舌
慧	绘,辉,灰,惠,会,恢,汇,挥,悔,毁,徽,回
豺	彩,才,采,菜,材,财,柴,裁,蔡,猜,拆
哀	矮,爱,碍,哎,挨,埃,唉,艾
综	忠,仲,纵,终,众,重,总,崇,宗,种,钟,衷,中,踪,肿
考	高,搞,靠,告,稿
勤	轻,庆,琴,侵,晴,请,倾,清,氢,亲,青,情,谨,秦
输	诉,疏,束,数,蔬,淑,署,树,叔,愉,喻,宿,枢,肃,愈,术,属,抒,俗,素,书,鼠,熟,舒,速,苏,塑,偷,述,竖,殊
裸	逻,弱,诺,螺,萝,若,络,落,洛,罗
笨	体,奔,本
巴	爸,拔,八,坝,叭,吧,霸,罢,把
拦	懒,郎,篮,然,南,烂,难,栏,滥,染,浪,兰,廊,览,燃,蓝,男,朗,狼
墅	诉,疏,束,数,蔬,淑,署,树,叔,宿,枢,肃,输,术,属,抒,俗,素,书,鼠,熟,舒,速,苏,塑,述,竖,殊
跷	侨,乔,悄,敲,巧,桥,瞧
魄	鬼,魏,婆,愧,迫,魂,泊,破,泼,颇,坡
溃	规,跪,鬼,愧,桂,贵,硅,轨,亏,龟,柜,遗,归
出	促,畜,触,除,粗,掘,储,屈,初,厨,处,础,楚
株	阻,柱,煮,驻,租,贮,嘱,主,祝,助,筑,珠,足,住,竹,铸,逐,组,祖,诸,猪,朱,族,注
擎	轻,敬,庆,琴,侵,晴,请,倾,清,氢,亲,青,情,勤,警,秦
尘	称,程,沉,惩,城,诚,衬,臣,承,呈,趁,陈,成,晨,撑,乘
络	弱,落,螺,诺,萝,各,洛,路,逻,若,裸,罗
侄	字,执,肢,滞,址,姿,致,稚,旨,志,到,直,滋,制,脂,织,支,汁,知,纸,指,资,兹,自,职,止,质,紫,芝,值,智,之,置,倒,秩,治,子,至,殖,植,只,枝
边	变,历,遍,辩,扁,编,辨,鞭,力,劫,励,动,便
奔	笨,本
找	招,遭,造,罩,爪,灶,早,兆,藻,召,照,燥,糟,赵
附	抚,扶,忽,副,服,湖,富,糊,乎,赋,复,夫,傅,妇,覆,幅,肤,呼,父,佛,辅,伏,付,胡,符,户,互,弗,腹,赴,咐,缚,浮,府,福,护,虎,腐,辐,负,甫
笋	瞬,顺,孙,损
康	杠,看,港,堪,坎,刊,岗,刚,纲,抗,砍,钢,炕
川	穿,船,闯,创,床,串,窗,传,喘
禽	轻,庆,琴,侵,晴,请,倾,清,氢,亲,青,情,勤,秦
幅	抚,扶,忽,副,服,湖,富,糊,乎,逼,赋,复,夫,傅,妇,覆,肤,呼,父,佛,辅,伏,付,胡,符,户,互,弗,腹,赴,咐,缚,浮,府,福,护,虎,腐,辐,负,甫,附
冠	广,贯,馆,惯,灌,宽,官,罐,观,管,关,光,款
廷	停,艇,亭,庭,听,厅,挺
僧	生,曾,升,增,圣,绳,声,盛,牲,森,剩,省,胜
淤	与,裕,玉,育,愚,誉,语,豫,遇,雨,宇,愉,喻,于,愈,渔,预,余,予,欲,寓,域,郁,狱,娱,羽,舆,鱼,御,浴
鹦	鹰,英,映,姻,吟,赢,影,因,迎,殷,隐,盈,应,印,阴,引,硬,营,颖,婴,音,饮,银
孝	效,萧,硝,销,消,笑,晓,校,小,肖
宋	松,耸,送,颂,讼
捌	爸,拔,八,坝,叭,吧,霸,罢,把,巴
寂	基,挤,集,济,鸡,脊,际,机,既,疾,祭,技,及,辑,吉,迹,级,急,极,积,饥,即,几,击,己,绩,肌,激,忌,计,季,继,寄,籍,剂,记,纪
酷	姑,骨,股,故,苦,固,鼓,雇,咕,库,孤,古,枯,谷,哭,裤,顾,估
砍	看,干,康,感,堪,甘,肝,赶,坎,敢,刊,抗,杆,炕
街	借,界,介,截,姐,皆,劫,捷,戒,届,杰,接,洁,竭,阶,节,结,解,揭
翰	凡,含,范,杭,泛,犯,饭,寒,反,汉,航,贩,罕,烦,番,繁,返,翻,喊,涵,韩,函,旱,汗
忍	仁,任,认,仍,扔,人
默	黑,莫,漠,摸,沫,陌,膜,摩,末,墨,魔,抹,模,磨
阐	缠,惨,参,肠,厂,唱,尝,偿,残,昌,蚕,场,畅,倡,常,禅,颤,餐,产
黄	荒,缓,皇,惶,幻,煌,环,欢,患,换,晃,慌,唤
趣	取,屈,驱,越,起,趟,超,渠,徒,躯,区,去,曲,走,趋
木	栖,亩,材,村,慕,墓,框,幕,林,母,牧,姆,穆,目
魁	规,跪,鬼,愧,料,桂,贵,科,硅,轨,亏,龟,魂,斗,柜,抖,归,魏,溃
均	匀,峻,军,俊,君,菌
行	醒,杏,兴,新,信,幸,欣,性,型,辛,心,姓,形,星,刑
袁	源,员,元,愿,远,原,渊,怨,圆,援,冤,园,缘,院
腕	万,汪,往,网,湾,忘,亡,旺,完,玩,顽,望,碗,挽,晚,妄,王,弯
驻	阻,柱,煮,租,贮,嘱,主,祝,往,助,筑,珠,足,住,竹,铸,逐,组,祖,诸,猪,朱,株,族,注
郊	胶,骄,校,焦,角,效,搅,脚,较,缴,教,交,咬,轿,娇,叫
降	碱,蒋,讲,匠,简,见,减,尖,箭,键,姜,剪,渐,奖,剑,件,健,建,江,疆,检,坚,将,兼,监,肩,鉴,间,艰,舰,僵,践,奸,歼,浆
陨	孕,员,允,运,匀,损,晕,云,蕴,韵
噪	招,遭,造,罩,爪,灶,找,早,兆,藻,召,照,燥,操,糟,赵
产	阐,缠,惨,参,肠,厂,唱,尝,偿,残,昌,蚕,场,畅,倡,常,禅,颤,餐
花	划,话,哗,画,滑,化,华
喇	钠,辣,拉,娜,蜡,拿,哪,啦,那,呐,纳,腊
告	高,搞,靠,考,稿
升	生,审,渗,婶,伸,身,绳,肾,省,什,慎,圣,声,申,牲,神,剩,深,沈,僧,胜,甚,盛
星	生,醒,行,杏,兴,新,信,幸,欣,性,型,辛,心,姓,形,刑
姊	字,执,肢,滞,址,姿,致,稚,旨,志,直,滋,制,脂,织,支,汁,知,纸,指,资,兹,自,职,止,质,紫,芝,值,智,之,置,秩,治,子,至,殖,植,只,枝
辙	这,择,哲,浙,著,折,朝,潮,者,遮,责,则,撤,泽,着
羹	坑,跟,耕,更,根
匈	胸,兄,熊,凶,雄
义	异,逸,役,医,抑,毅,一,益,议,疑,亦,乙,姨,宜,蚁,椅,移,译,疫,谊,亿,已,衣,依,遗,矣,易,仪,以,艺,伊,意,忆,翼
挎	刮,瓜,夸,污,寡,挂,跨
纽	柳,流,瘤,丑,硫,刘,牛,留,溜,扭,六
什	生,审,渗,婶,伸,升,身,绳,肾,省,慎,圣,声,申,牲,神,剩,深,沈,胜,甚,盛,森
警	禁,净,静,惊,金,京,敬,近,精,劲,锦,筋,镜,津,晋,境,景,竟,浸,尽,巾,经,井,茎,颈,竞,进,仅,睛,晶,紧,谨,今,径,斤
嘉	驾,夹,架,家,嫁,佳,钾,甲,假,加,贾,稼,价
怀	坏,淮
常	阐,苍,藏,缠,肠,厂,唱,尝,偿,昌,仓,场,畅,倡,舱,禅,颤,产
莹	鹰,英,映,姻,吟,赢,影,因,迎,殷,隐,盈,应,印,阴,引,硬,营,颖,婴,音,饮,银
另	淋,龄,铃,磷,邻,陵,灵,玲,凝,林,零,临,领,令,凌,岭,宁
单	氮,胆,弹,丹,党,但,当,旦,诞,荡,档,淡,挡,蛋,担
乘	尘,称,程,沉,惩,城,层,诚,衬,臣,承,呈,趁,曾,陈,成,晨,撑
米	迷,秘,蜜,弥,断,密,泌,继
凄	汽,期,岂,骑,栖,棋,气,奇,齐,旗,起,其,弃,歧,器,企,漆,戚,七,契,启,妻,欺
路	努,辱,录,怒,炉,儒,如,露,芦,入,各,洛,络,奴,陆,鲁,乳,碌,卢,鹿
苟	扣,钩,狗,够,口,句,构,沟,购,勾
捍	凡,含,范,杭,泛,犯,饭,寒,反,汉,航,贩,罕,烦,番,繁,返,翻,喊,涵,韩,函,旱,汗
顷	轻,庆,琴,侵,晴,请,倾,清,氢,亲,青,情,勤,秦
克	葛,格,隔,课,个,歌,棵,哥,可,革,胳,壳,阁,各,科,割,渴,客,鸽,颗,刻,戈
计	基,挤,集,济,鸡,寂,脊,际,机,既,疾,祭,技,及,辑,吉,迹,级,急,极,积,饥,即,几,击,己,绩,肌,激,忌,季,继,寄,籍,剂,记,纪
聋	农,绒,溶,熔,容,笼,浓,融,龙,隆,荣,拢,垄,弄
可	葛,格,隔,课,个,歌,棵,哥,革,胳,壳,阁,克,各,科,割,渴,客,鸽,颗,刻,戈
痛	筒,童,桶,涌,通,统,铜,同
函	凡,含,范,杭,泛,犯,饭,寒,反,汉,航,贩,罕,烦,番,繁,返,翻,喊,涵,韩,旱,汗
氛	冯,风,狠,疯,蜂,份,锋,缝,很,芬,峰,粉,封,凤,奉,丰,粪,奋,恨,愤,逢,分,坟,纷,痕
拗	傲,奥,澳,凹,幼
摸	默,莫,慕,漠,沫,陌,墓,幕,膜,摩,末,墨,魔,抹,模,磨
碍	矮,爱,哎,挨,哀,埃,唉,艾
枯	姑,骨,股,故,苦,固,酷,鼓,雇,咕,库,孤,古,谷,哭,裤,顾,估
粟	诉,疏,束,数,蔬,淑,署,树,叔,宿,枢,肃,输,术,属,抒,俗,素,书,鼠,熟,舒,速,苏,塑,述,竖,殊
促	础,储,粗,初,出,楚,畜,触,厨,处,除
崇	踪,匆,从,聪,冲,充,宗,综,丛,虫
访	凡,范,杭,泛,犯,妨,饭,房,反,仿,航,纺,方,贩,烦,番,繁,旅,返,翻,放,芳,防
筷	块,拐,快,怪
殿	奠,垫,典,淀,电,店,点,颠
遮	这,择,哲,浙,著,折,者,责,则,泽,着
衡	冯,风,狠,疯,蜂,恒,锋,缝,很,峰,封,凤,奉,丰,横,恨,哼,逢,痕
积	基,挤,集,济,鸡,寂,脊,际,机,既,疾,祭,技,及,辑,吉,迹,级,急,极,饥,即,几,击,己,绩,肌,激,忌,计,季,继,寄,籍,剂,记,纪
普	扑,铺,葡,仆,朴,谱
曾	称,程,惩,城,层,诚,增,承,呈,僧,成,撑,乘
塌	她,它,塔,拓,他,踏
厅	停,艇,亭,庭,听,廷,挺
炊	饮,坎,摧,吹,垂,脆,锤,催,粹,欢,崔,欠,翠
杉	上,衫,赏,珊,陕,三,商,散,善,伤,闪,山,扇,尚
叹	坦,滩,躺,谈,倘,堂,碳,糖,炭,探,贪,坛,塘,汤,唐,趟,摊
议	异,逸,役,医,抑,毅,义,一,益,疑,亦,乙,姨,宜,蚁,椅,移,译,疫,谊,亿,已,衣,依,遗,矣,易,仪,以,艺,伊,意,忆,翼
缅	勉,面,棉,免,绵,眠
殖	字,执,肢,滞,址,姿,致,稚,旨,志,直,滋,制,脂,织,支,汁,知,纸,指,资,兹,自,职,止,质,紫,芝,值,智,之,置,秩,治,子,至,植,只,枝
吐	涂,土,徒,途,突,屠,图,兔
硅	规,跪,鬼,愧,桂,贵,轨,亏,龟,柜,归,溃
进	禁,净,静,惊,金,京,敬,近,精,劲,锦,筋,镜,津,晋,境,景,竟,浸,尽,巾,经,井,茎,警,颈,竞,仅,睛,晶,紧,谨,今,径,斤
峰	冯,风,疯,蜂,份,衡,恒,氛,锋,缝,芬,粉,封,凤,奉,丰,粪,蓬,横,奋,哼,逢,分,坟,纷,愤
马	蚂,嘛,驱,吗,麻,驰,妈,码,驼,玛,骂
拘	巨,距,惧,拒,聚,俱,举,居,据,剧,菊,局,矩,句,具
舞	物,吴,五,乌,雾,屋,无,务,污,悟,午,伍,呜,武,吾,误
低	底,帝,弟,递,抵,蒂,第,滴,纸,迪,堤,氏,敌
察	叉,插,擦,茶,差,查
劫	借,界,边,介,截,动,街,姐,历,皆,捷,戒,届,杰,接,洁,励,力,竭,阶,节,结,解,揭
惫	贝,杯,卑,北,背,悲,碑,备,被,辈,倍
祭	基,挤,集,济,鸡,寂,脊,际,机,既,疾,技,及,辑,吉,迹,级,急,极,票,积,饥,即,几,击,己,绩,肌,示,激,忌,计,季,继,寄,籍,剂,记,纪,标
彪	标,表
玄	悬,弦,选,旋,宣
活	货,祸,伙,惑,或,霍,获,火
天	甜,夫,填,田,大,添
炼	梁,凉,谅,良,链,辆,恋,亮,连,练,联,两,怜,廉,粮,念,莲,年,量,帘,脸
验	焰,氧,阳,厌,严,言,养,颜,洋,央,沿,样,宴,燕,咽,秧,扬,盐,研,眼,炎,检,艳,烟,延,演,杨,掩,衍,签,仰,险,羊,脸,岩
爹	跌,蝶,叠
抒	诉,疏,束,数,蔬,淑,署,树,叔,宿,枢,肃,输,术,属,俗,素,书,鼠,熟,舒,速,苏,塑,述,竖,殊
替	体,踢,赞,题,潜,梯,提
问	温,吻,翁,文,纹,稳,闻
迂	与,裕,玉,育,愚,誉,语,吁,豫,遇,雨,宇,愉,喻,于,愈,渔,预,余,予,欲,寓,域,郁,狱,娱,羽,舆,鱼,御,浴
俏	敲,瞧,桥,梢,稍,巧,肖,乔,悄,哨,侨,销,硝,消
挫	错,措,座,坐
卑	贝,脾,杯,牌,北,背,悲,碑,备,被,辈,倍
趾	字,执,肢,滞,址,姿,致,稚,旨,志,直,滋,制,脂,织,支,汁,知,纸,耻,指,资,兹,自,职,止,质,紫,芝,值,智,之,置,秩,治,子,至,殖,植,只,枝
爵	掘,觉,决,绝
续	许,卖,序,叙,蓄,须,需,徐,虚,读,吁,绪
痕	狠,份,衡,恒,氛,很,芬,粉,粪,横,奋,恨,愤,哼,分,坟,纷
立	逆,黎,厉,拉,梨,理,李,利,离,礼,吏,厘,莉,历,哩,隶,你,丽,拟,尼,励,力,里,泥,日,例,粒,璃,站
搜	收,瘦,售,兽,受,守,首,寿,手,授
沸	菲,黑,匪,肥,弗,肺,非,嘿,废,佛,费,飞
褥	辱,录,炉,儒,如,露,芦,入,陆,路,鲁,乳,碌,卢,鹿
豪	耗,浩,好,号,毫
首	收,搜,瘦,售,兽,受,守,寿,手,授
唁	焰,氧,阳,厌,严,言,养,验,颜,洋,央,沿,样,宴,燕,咽,秧,扬,盐,研,眼,炎,艳,烟,延,演,杨,掩,衍,仰,羊,岩
藻	招,遭,造,罩,爪,灶,找,早,兆,召,照,燥,操,糟,赵
丈	葬,账,展,粘,章,长,占,掌,涨,脏,障,仗,张,战,沾,胀,帐,站
集	基,挤,济,鸡,寂,脊,际,机,既,疾,祭,技,及,辑,吉,迹,级,急,极,积,饥,即,几,击,己,绩,肌,激,忌,计,季,继,寄,籍,剂,记,纪
喂	畏,慰,委,胃,惟,威,味,围,危,伟,未,为,位,伪,谓,尾,卫,维,纬,微,魏,唯,违
弛	词,次,池,齿,瓷,刺,磁,也,持,驰,此,辞,施,耻,斥,尺,迟,慈,吃,翅,雌,赤
咱	沾,占,葬,暂,展,赞,粘,站,战,脏
翅	词,次,池,齿,瓷,刺,磁,持,驰,翔,此,辞,耻,斥,尺,羽,迟,慈,翻,吃,雌,赤
捡	碱,蒋,讲,匠,简,验,见,减,尖,箭,键,降,姜,剪,渐,奖,剑,件,健,建,江,疆,检,坚,将,兼,监,签,肩,鉴,险,间,艰,舰,僵,践,奸,脸,歼,浆
叨	盗,倒,岛,稻,导,蹈,刀,到,道
竿	杠,看,干,港,感,甘,堪,肝,赶,坎,敢,刊,岗,刚,纲,杆,砍,钢
抹	墨,陌,魔,莫,默,模,漠,膜,摸,磨,摩,末,沫
殃	焰,氧,映,阳,厌,严,言,养,验,颜,洋,央,沿,样,宴,燕,咽,秧,扬,盐,研,眼,炎,艳,烟,延,演,杨,掩,衍,仰,羊,岩
污	物,吴,五,乌,雾,舞,屋,无,务,夸,悟,午,跨,伍,呜,武,吾,误
捧	棚,碰,膨,朋,喷,彭,盆,奉,棒,蓬
漏	柔,楼,肉
厌	焰,氧,阳,严,言,养,验,颜,洋,央,沿,样,宴,燕,咽,秧,扬,盐,研,眼,炎,艳,烟,延,演,杨,掩,衍,仰,羊,岩
弗	抚,扶,忽,副,服,湖,富,糊,乎,赋,复,夫,沸,傅,妇,覆,幅,肤,呼,父,佛,辅,伏,付,胡,符,户,互,腹,赴,咐,缚,浮,府,福,护,虎,腐,辐,负,甫,附
脑	老,闹,牢,捞,恼,劳
泼	婆,迫,泊,破,颇,坡
度	渡,杜,督,赌,独,毒,堵,读,肚
扳	榜,斑,板,邦,膀,半,傍,伴,帮,班,棒,搬,扮,办,版,颁,般
缸	杠,干,港,康,感,甘,肝,赶,敢,岗,刚,纲,抗,杆,钢,炕
价	驾,夹,架,家,嫁,介,佳,钾,甲,假,加,阶,嘉,贾,稼
佩	胚,培,配,赔,陪
郭	括,国,扩,过,锅,裹,果,阔
净	禁,静,惊,金,京,敬,近,精,劲,锦,筋,镜,津,晋,境,景,竟,浸,尽,巾,经,井,茎,警,颈,竞,进,仅,睛,晶,紧,谨,今,径,斤
仆	扑,铺,葡,朴,补,谱,普,卜
艘	收,搜,瘦,售,兽,受,守,首,寿,手,授
婶	生,审,渗,伸,升,身,绳,肾,省,什,慎,圣,声,申,牲,神,剩,深,沈,胜,甚,盛,森
润	论,轮,伦
般	设,没,榜,役,斑,股,投,板,邦,膀,半,傍,伴,帮,班,棒,搬,扮,办,版,颁
狈	贝,杯,卑,北,背,悲,碑,备,被,辈,倍
掀	享,项,宪,显,乡,象,献,鲜,线,香,县,贤,想,现,翔,祥,箱,橡,相,腺,弦,仙,嫌,响,详,险,限,先,纤,陷,像,湘,向,闲
赌	渡,煮,署,绪,独,毒,者,肚,杜,读,都,督,诸,堵,度
犁	逆,黎,厉,梨,理,李,利,立,离,礼,吏,厘,莉,历,哩,隶,你,丽,拟,尼,励,力,里,泥,日,例,粒,璃
黯	暗,氨,岸,俺,案,按,昂,安
辆	梁,凉,谅,娘,良,链,恋,亮,连,练,炼,联,两,怜,廉,粮,莲,量,帘,脸
刃	忍,仁,任,认,仍,扔,人
口	扣,钩,狗,够,构,沟,购,勾
牢	老,闹,扰,捞,脑,恼,劳,饶,绕
闻	温,吻,翁,文,纹,稳,问
成	尘,称,程,沉,惩,城,层,诚,衬,臣,承,呈,趁,曾,盛,陈,晨,撑,乘
泛	凡,范,犯,妨,饭,房,寒,反,防,汉,仿,纺,方,罕,贩,函,烦,芝,番,繁,之,返,翻,喊,乏,涵,韩,放,芳,含,访,旱,汗
大	答,打,天,搭,达,夫
夸	刮,瓜,污,寡,挂,跨
瓣	榜,斑,辟,板,邦,辞,膀,半,傍,伴,辩,宰,帮,班,棒,搬,辛,扮,办,辨,辣,版,颁,避,般
档	氮,胆,单,弹,丹,党,但,当,旦,诞,荡,淡,挡,蛋,担
簿	不,布,步,补,捕,部
堰	焰,氧,阳,厌,严,言,养,验,颜,洋,央,沿,样,宴,燕,咽,秧,扬,盐,研,眼,炎,艳,烟,延,演,杨,掩,衍,仰,羊,岩
臭	凑,仇,愁,筹,丑,抽,瞅,酬,畴
膝	晰,戏,袭,析,悉,稀,习,吸,希,席,西,嘻,锡,细,隙,夕,息,溪,牺,系,惜,洗,喜,媳
淳	寸,村,存,醇,纯,唇,春
野	业,叶,爷,夜,冶,也,液,页
钞	巢,超,操,朝,抄,曹,槽,吵,草,潮
累	泪,蕾,类,螺,勒,雷,内
酌	卓,作,桌,捉,做,左,昨,座,坐
棚	碰,膨,朋,喷,捧,彭,盆,蓬
颊	假,家,甲,加,峡,狭,嘉,价,驾,嫁,佳,贾,稼,架,夹,钾
哥	葛,格,隔,课,融,个,歌,棵,可,革,胳,壳,阁,克,各,科,割,渴,客,鸽,颗,刻,戈
你	逆,黎,厉,尔,梨,理,李,利,立,离,礼,吏,厘,莉,历,哩,隶,丽,拟,弥,尼,励,力,里,泥,例,粒,璃
刻	葛,格,隔,课,个,歌,棵,咳,哥,可,革,胳,壳,阁,克,各,该,科,割,渴,客,鸽,颗,戈,核
膛	坦,滩,躺,谈,倘,堂,碳,糖,炭,探,贪,坛,塘,汤,唐,趟,叹,摊
蔼	矮,爱,碍,哎,挨,哀,埃,唉,艾
勉	面,挽,晚,逸,棉,免,绵,眠
痘	兜,斗,抖,豆,都
商	上,衫,赏,珊,陕,丧,善,伤,闪,山,嗓,扇,桑,尚
鹊	缺,猎,错,鸣,蜡,措,借,鸟,鹅,岛,雀,确,惜,却,腊
孙	瞬,顺,损
贪	坦,账,滩,躺,贫,吟,谈,倘,堂,碳,糖,责,炭,探,货,今,坛,塘,财,汤,念,贝,唐,趟,贺,负,叹,摊
酣	凡,含,范,杭,泛,犯,饭,寒,反,汉,航,贩,罕,烦,番,繁,返,翻,喊,涵,韩,函,旱,汗
叩	扣,钩,狗,够,口,构,沟,购,勾
和	喝,盒,合,何,贺,荷,赫,呵,河,核
纳	钠,辣,拉,娜,蜡,拿,哪,内,啦,那,呐,腊
摊	坦,滩,躺,谈,倘,堂,难,碳,糖,炭,探,贪,坛,塘,汤,唐,趟,叹
仲	忠,纵,终,众,重,总,宗,种,综,钟,衷,中,踪,肿
兢	禁,净,静,惊,金,京,敬,近,精,劲,锦,筋,镜,津,晋,境,景,竟,浸,尽,巾,经,井,茎,警,颈,竞,进,仅,睛,晶,紧,谨,今,径,斤
盟	蒙,萌,猛,门,们,梦,闷,孟
追	嘴,最,罪,醉
抬	台,太,泰,胎,态
徽	绘,辉,慧,灰,惠,会,恢,汇,挥,悔,毁,回
惕	体,锡,踢,易,替,题,梯,提
俺	暗,掩,氨,岸,案,按,昂,安
瑞	锐,端,喘
订	顶,打,丁,叮,盯,钉,定
骄	胶,桥,侨,郊,焦,角,搅,乔,脚,较,缴,教,交,轿,娇,叫
沦	论,轮,润,伦
妈	马,蚂,嘛,驱,吗,麻,驰,码,驼,玛,骂
蒜	酸,算
腥	醒,行,杏,兴,新,信,幸,欣,性,型,辛,心,姓,形,星,刑
登	灯,瞪,凳,等,邓
憋	别,弊,蔽
抄	沙,巢,超,操,纱,少,朝,曹,槽,吵,草,潮,妙
驰	词,次,池,齿,妈,驼,瓷,刺,磁,也,持,马,驱,吗,此,辞,施,耻,斥,尺,迟,慈,吃,翅,雌,赤,骂
谐	鞋,携,谢,斜,写,些,协,皆,械,歇,邪,卸,泄,胁
蚕	阐,苍,藏,缠,独,惨,参,残,虫,仓,禅,颤,舱,蛋,餐,产
诚	尘,称,程,沉,惩,城,层,衬,臣,承,呈,趁,曾,盛,陈,成,晨,撑,乘
育	与,裕,玉,愚,誉,语,豫,遇,雨,宇,脊,愉,喻,于,愈,月,渔,预,余,予,欲,寓,域,郁,狱,娱,羽,舆,朋,膊,鱼,御,浴,背
园	源,员,元,愿,远,原,渊,怨,圆,援,完,玩,冤,缘,袁,院
孵	抚,扶,忽,副,服,湖,富,糊,乎,赋,复,夫,傅,妇,覆,幅,肤,呼,父,佛,辅,伏,付,胡,符,户,互,弗,腹,赴,咐,缚,浮,府,福,护,虎,腐,辐,负,甫,附
逾	与,裕,玉,育,愚,誉,语,豫,遇,雨,宇,愉,喻,于,愈,渔,预,余,予,欲,寓,域,郁,狱,娱,羽,舆,鱼,御,浴
久	舅,究,旧,酒,救,九,纠,就
癌	矮,爱,碍,哎,挨,哀,埃,唉,艾
卜	博,剥,伯,补,玻,拨,勃,脖,播,扑,波,搏,驳,仆,膊,朴
说	所,悦,脱,锁,索,缩
遵	准,尊
愉	与,裕,玉,育,愚,誉,语,豫,遇,雨,宇,喻,于,愈,输,渔,预,余,予,欲,寓,域,郁,狱,娱,羽,舆,鱼,御,偷,浴
耕	坑,跟,更,根
栅	咋,炸,杂,扎
芳	凡,范,杭,泛,犯,妨,饭,房,反,仿,航,纺,方,贩,烦,番,繁,返,翻,放,防,访
隐	鹰,英,映,姻,吟,赢,影,因,迎,殷,盈,应,印,急,阴,引,硬,营,稳,颖,婴,音,饮,银
扎	咋,炸,杂
坏	怀,不,环,淮
矗	础,储,粗,初,出,楚,促,畜,触,厨,处,除
寺	市,实,司,尸,四,使,拾,室,适,食,世,私,是,施,逝,势,死,识,师,石,试,诗,始,释,蚀,斯,撕,十,湿,思,式,似,士,示,等,特,氏,丝,史,事,饲,视,驶,时,饰,失,待,持
搓	错,措
伞	衫,珊,扇,丧,散,善,闪,陕,三,桑,山,嗓
勺	稍,扫,梢,少,嫂,的,约,绍,哨,烧
吱	字,执,肢,滞,址,姿,致,稚,旨,志,直,滋,制,脂,织,支,汁,知,纸,指,资,兹,自,职,止,质,紫,芝,值,智,之,置,秩,治,子,至,殖,植,只,枝
染	懒,篮,然,烂,栏,滥,嚷,拦,兰,览,让,燃,蓝,壤
椰	业,叶,野,爷,夜,冶,也,液,页
珠	阻,柱,煮,驻,租,贮,嘱,主,祝,助,筑,足,住,竹,铸,逐,组,祖,诸,猪,朱,株,族,注
掌	葬,账,展,粘,章,长,占,涨,脏,障,仗,张,战,沾,丈,胀,帐,站
乳	辱,录,炉,儒,如,露,芦,入,陆,路,鲁,碌,卢,鹿
隆	农,绒,溶,熔,容,笼,浓,融,龙,荣,拢,垄,弄
埃	矮,爱,碍,哎,挨,哀,唉,艾
霍	货,祸,伙,惑,或,获,活,火
巳	市,实,司,寺,尸,四,使,拾,室,适,食,世,私,是,施,逝,势,死,识,师,石,试,诗,始,释,蚀,斯,撕,十,湿,思,式,似,士,示,氏,丝,史,事,饲,视,驶,时,饰,失
勘	看,干,康,感,堪,甘,肝,赶,坎,敢,刊,抗,杆,砍,甚,炕
凝	龄,铃,另,您,陵,灵,玲,零,领,令,凌,岭,宁
涣	荒,缓,皇,惶,幻,煌,环,欢,黄,患,换,晃,慌,唤
夹	假,家,甲,加,峡,狭,嘉,价,驾,嫁,佳,贾,稼,架,钾
沛	胚,培,配,佩,赔,陪
嵌	前,千,强,潜,迁,钱,歉,谦,遣,墙,欠,腔,签,抢,浅,铅,牵,枪
酱	碱,蒋,讲,匠,简,见,减,尖,箭,键,降,姜,剪,渐,奖,剑,件,健,建,江,疆,检,坚,将,兼,监,肩,鉴,间,艰,舰,僵,践,奸,歼,浆
恋	梁,凉,谅,亦,良,链,辆,迹,亮,连,变,练,蛮,炼,联,两,怜,廉,粮,念,莲,年,量,帘,脸
缆	懒,郎,篮,然,南,烂,难,栏,滥,染,浪,拦,兰,廊,览,燃,蓝,男,朗,狼
来	奈,赖,莱,乃,奶,耐
驶	市,实,司,寺,尸,四,使,拾,室,适,食,世,私,是,施,逝,势,死,识,师,石,试,诗,始,释,蚀,斯,撕,十,湿,思,式,似,士,示,氏,丝,史,事,饲,视,时,饰,失
蔑	灭
止	字,执,肢,滞,址,姿,致,稚,旨,志,直,滋,制,脂,织,支,汁,知,纸,耻,指,资,兹,自,职,质,紫,芝,值,智,之,置,秩,治,子,至,殖,植,只,枝
令	淋,龄,冷,铃,另,磷,邻,陵,灵,玲,凝,林,零,临,怜,领,凌,岭,宁
现	享,项,宪,显,乡,象,献,鲜,线,觉,香,县,贤,想,见,翔,祥,箱,掀,橡,相,腺,弦,仙,嫌,观,响,详,险,限,先,纤,陷,视,像,湘,向,闲
蛇	社,涉,设,色,舍,摄,射,舌
寿	收,搜,瘦,售,涛,兽,受,铸,守,筹,首,手,授
况	广,狂,框,矿,宽,光,款
退	腿,推
梆	榜,斑,板,邦,膀,半,傍,伴,帮,班,棒,搬,扮,办,版,颁,般
残	线,阐,苍,藏,缠,钱,惨,参,仓,蚕,禅,颤,舱,餐,浅,产,践
泌	迷,秘,蜜,弥,米,密
闭	笔,比,门,彼,逼,毕,壁,蔽,阔,鼻,碧,闯,闪,必,币,弊,闷,避,臂,闲
翔	享,项,宪,显,乡,象,献,鲜,线,香,县,贤,想,现,祥,箱,掀,橡,相,腺,弦,仙,嫌,响,详,羽,险,限,先,纤,陷,翻,像,翅,湘,向,闲
身	生,审,渗,婶,伸,升,绳,肾,省,射,什,慎,躲,圣,声,申,牲,神,剩,深,沈,胜,甚,盛,森
率	绿,女,虑,旅,铝,履,摔,吕,律,氯,驴
滔	陶,涛,萄,桃,讨,淘,套,逃,掏
砂	沙,纱,萨,刹,洒,杀,啥,撒,厦,傻
监	碱,篮,蒋,讲,匠,简,见,猛,减,滥,尖,箭,键,孟,降,盆,姜,剪,渐,奖,剑,件,健,建,盐,江,疆,检,坚,临,将,兼,蓝,肩,鉴,盒,间,艰,舰,僵,践,奸,歼,浆
匀	孕,允,运,晕,云,蕴,韵,均
祈	汽,期,岂,骑,凄,栖,棋,气,奇,齐,旗,起,其,弃,歧,器,企,漆,戚,七,契,启,妻,欺
羚	淋,龄,铃,另,磷,邻,陵,灵,玲,凝,林,零,临,领,令,凌,岭,宁
扒	爸,拔,八,坝,叭,吧,霸,罢,把,巴
宛	万,汪,往,网,湾,忘,亡,旺,完,玩,顽,望,碗,挽,晚,妄,王,弯
沉	尘,称,程,惩,城,诚,衬,臣,承,呈,趁,陈,成,晨,撑,乘
捏	劣,裂,猎,烈,咧,列
丐	概,慨,改,钙,盖,溉,该,开,凯
澳	傲,奥,凹
倘	坦,滩,躺,谈,堂,碳,糖,炭,探,贪,坛,塘,汤,唐,趟,叹,摊
躲	身,多,夺,射,朵
谷	裕,姑,骨,股,故,苦,固,酷,鼓,雇,俗,咕,库,孤,古,枯,哭,裤,顾,浴,估
坊	凡,范,杭,泛,犯,妨,饭,房,反,仿,航,纺,方,贩,烦,番,繁,返,翻,放,芳,防,访
彩	才,采,菜,材,财,柴,裁,蔡,猜,拆
历	逆,黎,厉,梨,理,李,边,利,立,离,礼,吏,动,厘,莉,哩,劫,隶,你,丽,拟,尼,励,力,里,泥,日,例,粒,璃
章	葬,账,展,粘,长,占,掌,涨,脏,障,仗,张,战,沾,丈,胀,帐,站
莱	奈,赖,来,乃,奶,耐
沐	栖,亩,材,村,慕,墓,框,幕,林,母,木,牧,姆,穆,目
读	渡,杜,卖,督,续,赌,独,毒,堵,肚,度
澄	尘,称,程,沉,惩,城,层,诚,衬,臣,承,呈,趁,曾,陈,成,晨,撑,乘
猴	否,侯,厚,候,后,喉
褐	喝,盒,合,何,贺,荷,竭,赫,呵,河,核,揭,渴,和
纪	基,挤,集,济,鸡,寂,脊,际,机,既,疾,祭,技,及,辑,吉,迹,级,急,极,积,饥,即,几,击,己,绩,肌,激,忌,计,季,继,寄,籍,剂,记
颜	焰,氧,阳,厌,严,言,养,验,洋,央,沿,样,宴,燕,咽,秧,扬,盐,研,眼,炎,艳,烟,延,演,杨,掩,衍,仰,羊,岩
馁	泪,蕾,类,勒,雷,内,累
落	逻,弱,诺,螺,萝,若,络,裸,洛,罗
驱	妈,驼,曲,欧,马,驰,吗,取,屈,趣,区,去,趋,渠,躯,骂
陈	尘,称,程,沉,惩,城,诚,衬,臣,承,呈,趁,成,晨,撑,乘
藤	疼,腾
系	晰,戏,袭,析,悉,稀,习,吸,希,席,西,嘻,锡,细,隙,夕,息,溪,牺,惜,洗,喜,媳
露	努,辱,录,怒,炉,儒,如,芦,入,奴,陆,路,鲁,乳,碌,卢,鹿
刘	柳,纽,流,瘤,硫,牛,留,溜,扭,六
菇	姑,骨,股,故,苦,固,酷,鼓,雇,咕,库,孤,古,枯,谷,哭,裤,顾,估
于	与,裕,玉,育,愚,誉,语,吁,豫,遇,雨,宇,愉,喻,愈,渔,预,余,予,欲,寓,域,郁,狱,娱,羽,舆,鱼,御,浴
蚁	异,逸,役,医,抑,毅,义,一,益,议,疑,亦,乙,姨,宜,椅,移,译,疫,谊,亿,已,衣,依,遗,矣,易,仪,以,艺,伊,意,忆,翼
猖	阐,苍,藏,缠,肠,厂,唱,尝,偿,昌,仓,场,畅,倡,舱,常,禅,颤,产
萎	畏,慰,委,胃,惟,威,味,围,危,伟,未,为,位,伪,谓,尾,卫,维,纬,微,魏,喂,唯,违
蛋	单,丹,旦,荡,挡,弹,但,独,档,担,虫,氮,胆,蚕,诞,淡,党,当
慌	荒,缓,皇,惶,幻,煌,环,欢,黄,患,换,晃,唤
延	焰,氧,阳,厌,严,言,养,验,颜,洋,央,沿,样,宴,燕,咽,秧,扬,盐,研,诞,眼,炎,艳,烟,演,杨,掩,衍,仰,羊,岩
雌	词,次,池,齿,瓷,刺,磁,持,驰,此,辞,耻,斥,尺,迟,慈,吃,翅,赤
牙	芽,押,雅,压,哑,鸦,鸭,崖,呀,亚
击	基,挤,集,济,鸡,寂,脊,际,机,既,疾,祭,技,及,辑,吉,迹,级,急,极,积,饥,即,几,己,绩,肌,激,忌,计,季,继,寄,籍,剂,记,纪
方	凡,范,杭,泛,犯,妨,饭,房,反,仿,航,纺,贩,烦,番,繁,旅,返,翻,放,芳,防,访
箱	享,项,霜,宪,显,乡,象,献,鲜,线,香,县,贤,想,现,翔,祥,掀,橡,相,腺,弦,仙,嫌,响,详,险,限,先,纤,陷,像,湘,向,闲
螺	弱,落,诺,萝,洛,络,逻,若,累,裸,罗
懂	冻,洞,冬,动,东,董
觉	见,掘,视,观,决,绝,现
慰	畏,委,胃,惟,威,味,围,危,伟,未,为,位,伪,谓,尾,卫,维,纬,微,魏,喂,唯,违
撒	沙,纱,萨,刹,洒,杀,啥,厦,砂,傻
盼	判,盘,叛,潘,庞,攀,旁,胖
围	畏,慰,委,胃,惟,威,味,危,伟,未,为,位,伪,谓,尾,卫,维,纬,微,魏,喂,唯,违
秋	球,求,愁,丘
搞	高,靠,告,考,稿
兜	斗,抖,豆,都
仍	忍,仁,任,认,愣,冷,扔,人
羡	享,项,宪,显,乡,象,献,鲜,线,香,县,贤,想,现,翔,祥,箱,掀,橡,相,腺,弦,仙,嫌,响,详,险,限,先,纤,陷,像,湘,向,闲
营	鹰,英,映,姻,吟,赢,影,因,迎,殷,隐,盈,应,印,阴,引,硬,颖,婴,音,饮,银
炎	焰,氧,烧,阳,厌,严,言,养,验,颜,煤,洋,央,沿,样,宴,火,燕,咽,秧,扬,盐,研,眼,艳,烟,延,演,杨,灾,掩,衍,仰,羊,岩
俭	碱,蒋,讲,匠,简,验,见,减,尖,箭,键,降,姜,剪,渐,奖,剑,件,健,建,江,疆,检,坚,将,兼,监,签,肩,鉴,险,间,艰,舰,僵,践,奸,脸,歼,浆
烫	坦,滩,躺,谈,倘,堂,碳,糖,炭,探,贪,坛,塘,汤,唐,趟,叹,摊
券	权,誉,倦,拳,圈,全,劝,泉,卷
膏	高,搞,靠,告,考,稿
锥	嘴,最,罪,醉,追
馅	享,项,宪,显,乡,象,献,鲜,线,香,县,贤,想,现,翔,祥,箱,掀,橡,相,腺,弦,仙,嫌,响,详,险,限,先,纤,陷,像,湘,向,闲
桥	侨,骄,乔,悄,敲,巧,瞧,轿,侨,娇
唤	荒,缓,皇,惶,幻,煌,环,欢,黄,患,换,晃,慌
墟	许,序,叙,续,蓄,须,需,徐,虚,吁,绪
脸	梁,凉,谅,验,良,链,辆,恋,亮,连,练,炼,联,两,检,怜,廉,粮,念,签,险,莲,年,量,帘
役	设,异,没,逸,医,抑,毅,义,一,益,议,疑,亦,股,乙,投,姨,宜,蚁,椅,移,译,疫,谊,亿,已,衣,依,遗,矣,易,仪,以,艺,伊,意,忆,般,翼
颁	榜,斑,板,邦,膀,半,傍,伴,帮,班,棒,搬,扮,办,版,般
轧	芽,押,雅,压,哑,鸦,鸭,崖,牙,呀,亚
拜	摆,白,柏,败,百
状	壮,赚,转,装,撞,砖,庄,专
禀	饼,兵,冰,滨,并,丙,宾,病
捆	昆,困,棍,滚
韩	凡,含,范,杭,泛,犯,饭,寒,反,汉,航,贩,罕,烦,番,繁,返,翻,喊,涵,函,旱,汗
际	基,挤,集,济,鸡,寂,脊,机,既,疾,祭,技,及,辑,吉,迹,级,急,极,积,饥,即,几,击,己,绩,肌,激,忌,计,季,继,寄,籍,剂,记,纪
眨	咋,炸,杂,乏,泛,扎
聘	拼,贫,耸,耻,瓶,职,品,凭,联,屏,评,苹,耳,平,萍,频
窖	胶,骄,郊,焦,角,搅,脚,较,缴,教,交,轿,娇,叫
茅	貌,帽,冒,毛,茂,贸,猫,矛
诊	争,整,珍,症,振,政,怎,挣,侦,证,睁,镇,阵,郑,趁,真,针,蒸,震,贞,正,征
锹	侨,乔,悄,敲,巧,桥,瞧
薇	畏,慰,委,胃,惟,威,味,围,危,伟,未,为,位,伪,谓,尾,卫,维,纬,微,魏,喂,唯,违
扫	灵,稍,梢,少,嫂,寻,绍,哨,雪,烧
菜	彩,才,采,材,财,柴,裁,蔡,猜,拆
淌	坦,滩,躺,谈,倘,堂,碳,糖,炭,探,贪,坛,塘,汤,唐,趟,叹,摊,尚
怔	诊,争,整,珍,症,振,政,侦,挣,证,睁,镇,增,阵,郑,真,针,蒸,震,贞,正,征
缕	绿,虑,数,楼,氯,驴,铝,吕,律,女,履,旅,率
衷	忠,仲,纵,终,众,重,总,宗,种,综,钟,中,踪,肿
张	葬,账,展,粘,章,长,占,掌,涨,脏,障,仗,战,沾,丈,胀,帐,站
忱	尘,称,程,沉,惩,城,诚,衬,臣,承,呈,趁,陈,成,晨,撑,乘
田	天,甜,填,添
犹	游,友,优,由,又,邮,油,幽,悠,右,忧,有,诱,幼,尤
哪	钠,辣,拉,娜,蜡,拿,啦,那,呐,纳,腊
涨	葬,账,展,粘,章,长,占,掌,脏,障,仗,张,战,沾,丈,胀,帐,站
典	奠,垫,淀,电,殿,店,点,颠
盖	概,慨,改,钙,溉,该,开,凯
鲫	基,挤,集,济,鸡,寂,脊,际,机,既,疾,祭,技,及,辑,吉,迹,级,急,极,积,饥,即,几,击,己,绩,肌,激,忌,计,季,继,寄,籍,剂,记,纪
暖	乱,缓,援,卵
后	否,侯,厚,猴,候,喉
蹈	盗,倒,岛,稻,导,刀,到,道
桑	丧,散,伤,上,嗓,三,赏,尚,商
惦	奠,垫,典,淀,电,殿,店,点,颠
政	诊,争,整,珍,症,振,侦,挣,证,睁,镇,增,阵,郑,真,针,蒸,震,贞,正,征
果	括,国,扩,过,颗,郭,锅,课,裹,棵,阔
遭	招,造,罩,爪,灶,找,早,槽,兆,藻,召,照,燥,曹,糟,赵
色	社,涉,设,舍,摄,蛇,射,舌
旁	判,膀,盼,傍,盘,叛,潘,榜,庞,攀,胖
簸	玻,拨,勃,脖,博,播,膊,波,剥,驳,搏,伯,卜
棘	基,挤,集,济,鸡,寂,脊,际,机,既,疾,祭,技,及,辑,吉,迹,级,急,极,积,饥,即,几,击,己,绩,肌,激,忌,计,季,继,寄,籍,剂,记,纪
忌	基,挤,集,济,鸡,寂,脊,际,机,既,疾,祭,技,及,辑,吉,迹,级,急,极,积,饥,即,几,击,己,绩,肌,激,计,季,继,寄,籍,剂,记,纪
剑	碱,蒋,讲,匠,简,见,减,尖,箭,键,降,姜,剪,渐,奖,件,健,建,江,疆,检,坚,将,兼,监,肩,鉴,间,艰,舰,僵,践,奸,歼,浆
友	游,优,由,又,邮,犹,油,幽,悠,右,忧,有,诱,幼,尤
做	卓,作,桌,捉,左,昨,座,坐
上	衫,赏,珊,陕,商,丧,善,伤,闪,山,嗓,扇,桑,尚
昼	奏,州,宙,洲,走,轴,皱,骤,周
堕	躲,多,夺,朵
岗	杠,干,港,康,感,甘,肝,赶,敢,刚,纲,抗,杆,钢,炕
弃	汽,期,岂,骑,凄,栖,棋,气,奇,齐,旗,起,其,歧,器,企,漆,戚,七,契,启,妻,欺
窒	字,执,肢,滞,址,姿,致,稚,旨,志,到,直,滋,制,脂,织,支,汁,知,纸,指,资,兹,自,职,止,质,紫,芝,值,智,之,置,倒,秩,治,子,至,殖,植,只,枝
冯	风,疯,蜂,份,衡,恒,氛,锋,缝,芬,峰,粉,封,凤,奉,丰,粪,横,奋,哼,逢,分,坟,纷,愤
回	绘,辉,慧,灰,惠,会,恢,汇,挥,悔,毁,徽
诞	氮,胆,单,弹,丹,党,但,当,延,旦,荡,档,淡,挡,蛋,担
裤	姑,骨,股,故,苦,固,酷,鼓,雇,咕,库,孤,古,枯,谷,哭,顾,估
橙	尘,称,凳,程,沉,惩,城,层,诚,登,衬,臣,承,呈,趁,曾,陈,成,晨,撑,乘
募	亩,木,牧,姆,墓,幕,慕,穆,目,母
店	奠,垫,典,淀,电,殿,点,颠
公	功,宫,控,巩,工,孔,贡,弓,供,空,共,攻,恐,恭
删	上,衫,赏,珊,陕,三,商,散,善,伤,闪,山,扇,尚
独	渡,杜,蛋,蚕,督,赌,毒,堵,读,肚,度,虫
戚	汽,期,岂,骑,凄,栖,棋,气,奇,齐,旗,起,其,弃,歧,器,企,漆,七,契,启,妻,欺
员	源,元,愿,远,原,渊,怨,圆,援,损,冤,园,缘,袁,院
瀑	爆,扑,铺,葡,仆,朴,暴,谱,普
魏	鬼,畏,慰,委,胃,惟,威,味,围,愧,危,伟,未,为,位,伪,魂,谓,尾,卫,维,纬,微,喂,唯,违
群	裙,洋,羊,鲜,君,样,详
丁	顶,打,叮,盯,钉,定,订
顶	丁,叮,盯,钉,定,订
缠	阐,惨,参,肠,厂,唱,尝,偿,残,昌,蚕,场,畅,倡,常,禅,颤,餐,产
跤	胶,骄,郊,焦,角,搅,脚,较,缴,教,交,轿,娇,叫
兑	队,说,堆,脱,悦,对
金	禁,净,静,惊,京,敬,近,精,劲,锦,筋,镜,津,链,钱,晋,键,铜,境,景,竟,浸,尽,巾,经,井,茎,警,颈,针,竞,进,仅,睛,晶,紧,谨,今,径,斤
烹	棚,碰,膨,朋,喷,捧,彭,盆,蓬
冀	基,挤,集,济,鸡,寂,脊,际,机,既,疾,祭,技,及,辑,吉,迹,级,急,极,积,饥,即,几,击,己,绩,肌,激,忌,计,季,继,寄,籍,剂,记,纪
斜	鞋,携,除,谢,叙,途,徐,写,些,协,谐,余,械,歇,邪,涂,卸,泄,胁
风	冯,疯,蜂,份,衡,恒,氛,锋,缝,芬,峰,粉,封,凤,奉,丰,粪,横,奋,哼,飘,逢,分,坟,纷,愤
依	异,逸,役,医,抑,毅,义,一,益,议,疑,亦,乙,姨,宜,蚁,椅,移,译,疫,谊,亿,已,衣,遗,矣,易,仪,以,艺,伊,意,忆,翼
绊	判,榜,斑,板,邦,膀,半,傍,伴,帮,班,棒,搬,扮,办,叛,版,颁,般
馍	墨,陌,魔,莫,默,抹,模,漠,膜,摸,磨,摩,末,沫
苔	台,太,抬,泰,胎,态
字	执,肢,滞,址,姿,致,稚,旨,志,直,滋,制,脂,织,支,汁,知,纸,指,资,兹,自,职,止,质,紫,芝,值,智,之,置,秩,治,子,至,殖,植,只,枝
顽	顺,万,汪,往,网,湾,须,忘,页,亡,旺,烦,完,玩,望,碗,领,挽,晚,妄,王,弯
尽	禁,净,静,惊,金,京,敬,近,精,劲,锦,筋,镜,津,晋,境,景,竟,浸,巾,经,井,茎,警,颈,竞,进,仅,睛,晶,紧,谨,今,径,斤
瓶	频,苹,品,凭,平,拼,屏,萍,贫,评
挚	字,执,肢,滞,址,姿,致,稚,旨,志,直,滋,制,脂,织,支,汁,知,纸,指,资,兹,自,职,止,质,紫,芝,值,智,之,置,秩,治,子,至,殖,植,只,枝
按	暗,氨,岸,俺,案,昂,安
赵	招,遭,造,罩,爪,灶,找,早,兆,藻,召,照,燥,糟
剂	基,挤,集,济,鸡,寂,脊,际,机,既,疾,祭,技,及,辑,吉,齐,迹,级,急,极,积,饥,即,几,击,己,绩,肌,激,忌,计,季,继,寄,籍,记,纪
党	氮,胆,单,弹,丹,但,当,旦,诞,荡,档,淡,挡,蛋,担
阵	诊,争,整,珍,症,振,政,怎,挣,侦,证,睁,镇,郑,真,针,蒸,震,贞,正,征
溉	既,概,慨,改,钙,盖,该,开,凯
拢	农,绒,溶,熔,容,笼,浓,融,龙,隆,荣,垄,弄,庞
寞	墨,陌,魔,莫,默,抹,模,漠,膜,摸,磨,摩,末,沫
聊	辽,疗,鸟,料,僚,尿
壶	抚,扶,忽,副,服,湖,富,糊,乎,赋,复,夫,傅,妇,覆,幅,肤,呼,父,佛,辅,伏,付,胡,符,户,互,弗,腹,赴,咐,缚,浮,府,福,护,虎,腐,辐,负,甫,附
燃	懒,篮,然,烂,栏,滥,嚷,染,拦,兰,览,让,蓝,壤
织	字,执,肢,滞,址,姿,致,稚,旨,志,直,滋,制,脂,支,汁,知,纸,识,指,资,兹,自,职,止,质,紫,芝,值,智,之,置,秩,治,子,至,殖,植,只,枝
纠	舅,究,旧,久,酒,救,九,就
澈	测,策,朝,彻,车,扯,撤,册,侧,潮
馈	规,跪,鬼,愧,桂,贵,硅,轨,亏,龟,柜,归,溃
呀	芽,押,雅,压,哑,鸦,鸭,崖,牙,亚
隅	与,裕,玉,育,愚,誉,语,豫,遇,雨,宇,愉,喻,于,愈,渔,预,余,予,欲,寓,域,郁,狱,娱,羽,舆,鱼,御,浴
县	享,项,宪,显,乡,象,献,鲜,线,香,贤,想,现,翔,祥,箱,掀,橡,相,腺,弦,仙,嫌,响,详,险,限,先,纤,陷,像,湘,向,闲
濒	饼,兵,冰,滨,并,丙,宾,病
谣	姚,咬,摇,腰,邀,瑶,要,耀,药,遥
站	暂,贴,账,展,拉,粘,章,长,立,占,掌,涨,障,仗,张,咱,战,沾,丈,胀,赞,帐,粒
间	碱,蒋,讲,匠,简,见,减,尖,箭,键,降,姜,剪,渐,奖,剑,件,健,建,江,疆,检,坚,将,兼,监,肩,鉴,艰,舰,僵,践,奸,歼,浆
仁	忍,任,认,仍,扔,人
竟	禁,净,静,惊,金,京,敬,近,精,劲,锦,筋,镜,津,晋,境,景,浸,尽,巾,经,井,茎,警,颈,竞,进,仅,睛,晶,紧,谨,今,径,斤
威	畏,慰,委,胃,惟,味,围,危,伟,未,为,位,伪,谓,尾,卫,维,纬,微,魏,喂,唯,违
卤	努,辱,录,怒,炉,儒,如,露,芦,入,奴,陆,路,鲁,乳,碌,卢,鹿
戏	晰,袭,析,悉,稀,习,吸,希,席,西,嘻,锡,细,隙,夕,息,溪,牺,系,惜,洗,喜,媳
棵	葛,格,隔,课,个,歌,哥,可,革,胳,壳,阁,克,各,果,科,割,渴,客,鸽,颗,刻,戈
吠	菲,黑,匪,肥,肺,非,嘿,废,费,飞,沸
贞	诊,争,整,珍,症,振,政,怎,挣,侦,证,睁,镇,阵,郑,真,针,蒸,震,正,征
趁	诊,尘,称,程,沉,珍,惩,城,诚,衬,臣,承,呈,陈,成,晨,撑,乘
差	叉,插,擦,察,茶,查
弦	享,项,宪,显,乡,象,献,鲜,线,香,县,贤,想,现,翔,祥,箱,掀,橡,玄,相,腺,仙,嫌,响,详,险,限,先,纤,陷,像,湘,向,闲
芯	醒,行,杏,兴,新,信,幸,欣,性,型,辛,心,姓,形,星,刑
当	氮,胆,单,弹,丹,党,但,旦,诞,荡,档,淡,挡,蛋,担
酬	凑,醉,配,仇,愁,酒,筹,臭,丑,抽,瞅,畴
窍	侨,乔,悄,敲,巧,桥,瞧
兆	招,遭,挑,造,逃,罩,爪,桃,灶,找,早,藻,召,照,燥,糟,赵
溶	绒,熔,拢,容,笼,融,龙,隆,荣,垄
仓	苍,藏,惨,参,肠,厂,唱,尝,偿,残,昌,蚕,场,畅,倡,舱,常,白,餐,抢,枪
屏	频,苹,品,凭,平,拼,瓶,萍,贫,评
坦	滩,旦,躺,谈,倘,堂,碳,糖,但,炭,担,探,胆,贪,坛,塘,汤,唐,趟,叹,摊
循	训,讯,旬,寻,迅,询,逊,巡
批	披,譬,匹,皮,辟,疲,屁,脾
八	爸,拔,坝,叭,吧,霸,罢,把,巴
密	迷,秘,蜜,弥,米,必,泌
庵	暗,氨,岸,俺,案,按,昂,安
矩	巨,距,惧,拒,聚,俱,举,居,据,剧,柜,菊,局,拘,句,具
聆	淋,龄,铃,另,磷,邻,陵,灵,玲,凝,林,零,临,领,令,凌,岭,宁
魂	婚,鬼,魏,愧,浑,昏,混
武	物,吴,五,乌,雾,舞,屋,无,务,污,悟,午,伍,呜,吾,误
罩	招,遭,造,爪,灶,找,早,兆,藻,召,照,燥,糟,赵
溺	逆,黎,厉,梨,理,李,利,立,离,礼,吏,厘,莉,历,哩,隶,你,丽,拟,尼,励,力,里,泥,例,粒,璃
碧	闭,笔,比,彼,逼,毕,壁,蔽,鼻,必,币,弊,避,臂
勿	物,吴,五,乌,雾,舞,屋,无,务,污,悟,午,伍,呜,武,吾,误
尸	市,实,司,寺,四,使,拾,室,适,食,世,私,是,施,逝,势,死,识,师,石,试,诗,始,释,蚀,斯,撕,十,湿,思,式,似,士,示,氏,丝,史,事,饲,视,驶,时,饰,失
化	划,话,哗,花,画,滑,华
女	绿,虑,旅,铝,率,履,吕,律,要,氯,妥,驴
荷	喝,盒,合,何,贺,赫,呵,河,核,和
葛	格,隔,课,个,歌,棵,哥,可,革,胳,壳,阁,克,各,科,割,渴,客,鸽,颗,刻,戈
俗	裕,诉,疏,束,数,蔬,淑,署,树,叔,宿,枢,肃,输,术,属,抒,素,书,鼠,熟,舒,速,苏,塑,谷,浴,述,竖,殊
褪	退,腿,推
汞	功,宫,控,巩,工,孔,贡,弓,供,空,共,公,攻,恐,恭
茫	忙,蛮,漫,慢,曼,盲,满
散	衫,珊,扇,丧,善,闪,陕,三,桑,山,嗓
答	打,给,塔,搭,合,哈,拾,达,恰,大
笔	闭,比,彼,逼,毕,壁,蔽,鼻,碧,必,币,弊,避,臂
某	谋,煤,媒
拳	权,圈,全,劝,泉,券
僚	辽,疗,鸟,料,尿,聊
跋	爸,拔,八,坝,叭,吧,霸,罢,把,巴
试	市,实,司,寺,尸,四,使,拾,室,适,食,世,私,是,施,逝,势,死,识,师,石,诗,始,释,蚀,斯,撕,十,湿,思,式,似,士,示,氏,丝,史,事,饲,视,驶,时,饰,失
闯	川,阔,闭,穿,船,门,闪,创,闷,床,串,窗,传,喘,闲
吻	温,翁,文,纹,稳,问,闻
保	报,堡,薄,爆,饱,包,胞,抱,暴,宝
痒	焰,氧,疗,阳,厌,严,言,养,验,颜,洋,央,沿,样,疼,病,宴,燕,咽,秧,扬,盐,研,眼,炎,艳,烟,延,演,杨,瘦,掩,衍,仰,羊,岩
孕	允,运,匀,晕,云,蕴,韵
忠	仲,纵,终,众,重,总,宗,种,综,钟,衷,中,踪,肿
敷	抚,扶,忽,副,服,湖,富,糊,铺,乎,赋,复,夫,傅,妇,覆,幅,肤,呼,父,佛,辅,搏,伏,付,胡,符,户,互,弗,腹,赴,咐,缚,浮,捕,府,福,膊,护,虎,腐,辐,负,甫,附
盲	忙,蛮,漫,茫,慢,曼,满
昏	婚,浑,魂,混
烁	乐,所,说,锁,索,缩
烘	鸿,轰,哄,洪,红,宏
每	没,美,妹,海,梅,悔,枚,煤,霉,眉,媒
折	晰,这,择,哲,浙,著,拆,近,者,遮,责,则,析,泽,着,斤
冤	源,员,元,愿,远,原,渊,怨,圆,援,园,缘,袁,院
朽	修,羞,绣,袖,秀,休
讨	寸,过,陶,涛,萄,桃,守,村,衬,时,淘,套,逃,掏,付,对
迫	婆,泊,破,泼,颇,坡
宰	再,债,栽,辟,辞,仔,摘,窄,寨,辩,载,在,灾,辛,辨,辣,避,宅
庄	状,壮,赚,转,装,撞,砖,专
归	规,跪,鬼,愧,桂,贵,硅,轨,亏,龟,柜,溃
燕	焰,氧,阳,厌,严,言,养,验,颜,洋,央,沿,样,宴,咽,秧,扬,盐,研,眼,炎,艳,烟,延,演,杨,掩,衍,仰,羊,岩
蹂	柔,楼,肉,漏
片	篇,骗,偏
客	葛,格,隔,课,个,歌,棵,哥,可,革,胳,壳,阁,克,各,科,割,渴,鸽,颗,刻,戈
践	碱,线,蒋,讲,匠,简,见,减,钱,尖,箭,键,降,姜,残,剪,渐,奖,剑,件,健,建,江,疆,检,坚,将,兼,监,肩,鉴,间,艰,浅,舰,僵,奸,歼,浆
级	基,挤,集,济,鸡,寂,脊,际,机,既,疾,祭,技,吸,及,辑,吉,迹,急,极,积,饥,即,几,击,己,绩,肌,激,忌,计,季,继,寄,籍,剂,记,纪
祷	涛,铸,盗,倒,筹,寿,岛,稻,导,蹈,刀,到,道
博	剥,伯,玻,拨,勃,脖,播,傅,波,搏,驳,缚,薄,膊,卜
干	杠,看,港,感,甘,堪,肝,赶,坎,敢,刊,岗,刚,纲,杆,砍,钢
适	市,实,司,寺,尸,四,使,拾,室,食,世,私,是,施,逝,势,死,识,师,石,试,诗,始,释,蚀,斯,撕,十,湿,思,式,似,士,示,氏,丝,史,事,饲,视,驶,时,饰,失
址	字,执,肢,滞,姿,致,稚,旨,志,直,滋,制,脂,织,支,汁,知,纸,耻,指,资,兹,自,职,止,质,紫,芝,值,智,之,置,秩,治,子,至,殖,植,只,枝
甲	驾,夹,架,家,嫁,佳,钾,假,加,嘉,贾,稼,价
固	姑,骨,股,故,苦,酷,鼓,雇,咕,库,孤,古,枯,谷,哭,裤,顾,估
癸	规,跪,鬼,愧,桂,贵,硅,轨,亏,龟,柜,归,溃
庶	诉,疏,束,数,蔬,淑,署,树,叔,宿,枢,肃,输,术,属,抒,俗,素,书,鼠,熟,舒,速,苏,塑,述,竖,殊
便	变,遍,硬,辩,扁,编,辨,鞭,更,边
也	驰,业,叶,野,爷,施,夜,冶,液,页
占	暂,贴,账,展,粘,章,长,掌,涨,障,仗,张,咱,战,沾,丈,胀,赞,帐,站
啸	效,萧,硝,销,孝,消,笑,晓,校,小,肖
懦	逻,诺,螺,需,萝,络,儒,落,裸,洛,罗
语	与,裕,玉,育,愚,誉,豫,遇,雨,宇,愉,喻,于,悟,愈,渔,预,余,予,欲,寓,域,郁,狱,娱,羽,舆,鱼,御,浴,吾
兰	懒,郎,篮,然,南,烂,难,栏,滥,染,浪,拦,廊,览,燃,蓝,男,朗,狼
摩	默,莫,漠,摸,麻,沫,陌,膜,末,墨,魔,抹,模,磨
防	凡,范,杭,泛,犯,妨,饭,房,反,仿,航,纺,方,贩,烦,番,繁,旅,返,翻,放,芳,访
肛	杠,干,港,康,感,甘,肝,赶,敢,岗,刚,纲,抗,杆,钢,炕
篡	川,船,穿,传,串,喘
骗	遍,篇,片,扁,编,偏
六	柳,纽,流,瘤,硫,刘,牛,留,溜,扭
硝	萧,孝,笑,校,梢,效,稍,晓,小,肖,悄,哨,销,消
帖	沾,占,贴,粘,站,战,铁
盆	碰,喷,棚,猛,捧,彭,孟,膨,盐,蓬,监,朋,盒
扼	恶,鹅,鄂,俄,饿,额
竣	峻,军,俊,君,菌,均
钠	辣,拉,娜,蜡,拿,哪,啦,那,呐,纳,腊
拄	阻,柱,煮,驻,租,贮,嘱,主,祝,助,筑,珠,足,住,竹,铸,逐,组,祖,诸,猪,朱,株,族,注
奸	碱,蒋,讲,匠,简,见,减,尖,箭,键,降,姜,剪,渐,奖,剑,件,健,建,江,疆,检,坚,将,兼,监,肩,鉴,间,艰,舰,僵,践,歼,浆
躺	坦,滩,谈,倘,堂,碳,糖,炭,探,贪,坛,塘,汤,唐,趟,叹,摊,尚
讽	冯,风,疯,蜂,份,衡,恒,氛,锋,缝,芬,峰,粉,封,凤,奉,丰,粪,横,奋,哼,飘,逢,分,坟,纷,愤
魅	没,美,妹,梅,枚,煤,每,霉,眉,媒
洞	冻,懂,冬,动,东,董
棺	广,贯,馆,惯,灌,宽,官,罐,观,冠,管,关,光,款
瞭	辽,疗,鸟,料,僚,尿,聊
寨	摘,窄,宰,再,灾,在,载,宅,债,仔,栽
板	榜,斑,饭,邦,反,膀,半,傍,伴,帮,班,棒,搬,扮,办,版,颁,返,般
潜	前,千,强,迁,钱,歉,谦,遣,墙,欠,腔,签,抢,赞,替,浅,铅,牵,枪
坠	嘴,最,罪,醉,追
晴	轻,庆,琴,侵,请,倾,清,猜,氢,亲,青,睛,情,勤,秦
忙	亡,蛮,漫,茫,慢,曼,盲,满
烂	懒,郎,篮,然,南,难,栏,滥,染,浪,拦,兰,廊,览,燃,蓝,男,朗,狼
嚷	朗,郎,然,壤,让,染,浪,燃,狼,廊
伴	判,榜,斑,板,邦,膀,半,傍,帮,班,棒,搬,扮,办,叛,版,颁,般
椒	胶,骄,淑,郊,焦,角,叔,搅,脚,较,缴,教,交,督,轿,娇,叫
爪	招,遭,造,罩,灶,找,早,兆,藻,召,照,燥,糟,赵
力	逆,黎,厉,梨,理,李,边,利,立,离,礼,吏,动,厘,莉,历,哩,劫,隶,你,丽,拟,尼,励,里,泥,日,例,粒,璃
撮	错,措
枢	诉,疏,束,数,蔬,淑,署,树,叔,宿,肃,输,术,属,抒,俗,素,书,鼠,熟,舒,速,苏,塑,述,竖,殊
亚	芽,押,雅,压,哑,鸦,鸭,崖,牙,呀
凶	胸,兄,熊,雄
嫌	享,项,宪,显,乡,象,献,鲜,线,香,县,贤,想,现,翔,祥,歉,箱,掀,橡,相,谦,腺,弦,仙,响,廉,详,兼,赚,险,限,先,纤,陷,像,湘,向,闲
柬	碱,蒋,讲,匠,简,见,减,尖,箭,键,降,姜,剪,渐,奖,剑,件,健,建,江,疆,检,坚,将,兼,监,肩,鉴,间,艰,舰,僵,践,奸,歼,浆
界	借,介,截,街,姐,皆,劫,捷,戒,届,杰,接,洁,竭,阶,节,结,解,揭
昂	暗,氨,岸,俺,案,按,安
沟	扣,钩,狗,够,口,构,购,勾
揪	舅,究,旧,久,酒,救,愁,九,秋,纠,就
尬	卡
峻	军,俊,君,菌,均
蓬	棚,碰,膨,朋,峰,蜂,喷,捧,逢,缝,锋,彭,盆
矢	市,实,司,寺,尸,四,使,拾,室,适,食,世,私,是,施,逝,势,死,识,师,石,试,诗,始,释,蚀,斯,撕,十,湿,思,式,似,士,示,氏,丝,史,事,饲,视,驶,时,饰,失
醇	寸,村,存,纯,唇,春
媒	某,谋,没,美,妹,梅,枚,煤,每,霉,眉
稿	高,搞,靠,告,考
舌	社,涉,设,刮,括,色,乱,舍,摄,蛇,射
皮	披,彼,脾,玻,辟,波,被,坡,皱,譬,匹,疲,疲,破,屁,批
著	童,埋,这,择,哲,浙,折,里,理,者,遮,责,则,泽,着
壹	异,逸,役,医,抑,毅,义,一,益,议,疑,亦,乙,姨,宜,蚁,椅,移,译,疫,谊,亿,已,衣,依,遗,矣,易,仪,以,艺,伊,意,忆,翼
掏	陶,涛,萄,桃,讨,淘,套,逃
凑	奏,仇,愁,筹,臭,丑,抽,瞅,酬,畴
吴	物,五,乌,雾,舞,屋,无,务,污,悟,午,伍,呜,娱,武,吾,误
畸	基,挤,集,济,鸡,寂,脊,际,机,既,疾,祭,技,及,辑,奇,吉,椅,迹,级,急,极,积,饥,即,几,击,己,绩,肌,激,忌,计,季,继,寄,籍,剂,记,纪
乖	块,拐,快,怪
氨	暗,岸,俺,案,按,昂,安
驼	马,托,拖,驱,驰,吗,妈,脱,妥,骂
捞	老,闹,牢,扰,脑,恼,劳,饶,绕
码	马,蚂,嘛,吗,麻,妈,玛,骂
翁	温,吻,文,纹,稳,问,闻
溅	碱,蒋,讲,匠,简,见,减,尖,箭,键,降,姜,剪,渐,奖,剑,件,健,建,江,疆,检,坚,将,兼,监,肩,鉴,间,艰,舰,僵,践,奸,歼,浆
封	冯,风,挂,崖,疯,蜂,份,娃,衡,恒,氛,锋,缝,桂,蛙,芬,峰,粉,佳,凤,奉,丰,粪,横,奋,哼,逢,分,坟,纷,愤
巅	奠,垫,典,淀,电,殿,店,点,颠
砖	状,壮,赚,转,装,撞,钻,庄,专
顿	敦,蹲,吨,盾
塑	诉,疏,束,数,蔬,淑,署,树,叔,宿,枢,肃,输,术,属,抒,俗,素,书,鼠,熟,舒,速,苏,述,竖,殊
莫	默,慕,漠,摸,沫,陌,墓,幕,膜,摩,末,墨,魔,抹,模,磨
彭	棚,碰,膨,朋,喷,捧,盆,蓬
裕	与,玉,育,愚,誉,语,豫,遇,雨,宇,愉,喻,于,愈,渔,预,余,俗,予,欲,寓,域,郁,狱,娱,羽,舆,谷,鱼,御,浴
菩	扑,铺,葡,仆,朴,谱,普
右	游,友,优,由,又,邮,犹,油,幽,悠,忧,有,诱,幼,尤
办	榜,斑,板,邦,膀,半,傍,协,伴,帮,班,棒,搬,扮,苏,版,颁,般,胁
巢	超,操,朝,抄,曹,槽,吵,草,潮
臀	吞
浙	晰,这,择,哲,著,折,拆,近,者,遮,责,则,析,泽,着,斤
合	答,给,塔,喝,盒,搭,哈,拾,何,贺,荷,赫,呵,河,恰,核,和
假	驾,夹,架,家,嫁,霞,佳,钾,甲,加,嘉,贾,稼,价
拴	酸,霜,爽,双,算
蝶	跌,泄,爹,世,叠
滴	底,帝,弟,递,低,抵,蒂,第,迪,堤,敌
蔡	彩,才,采,菜,材,财,柴,裁,猜,拆
壳	葛,格,隔,课,个,歌,棵,哥,可,革,胳,阁,克,各,科,割,渴,客,鸽,颗,刻,戈
倚	异,逸,役,医,抑,毅,义,一,益,议,疑,亦,乙,奇,姨,宜,蚁,椅,移,译,疫,谊,亿,已,衣,依,遗,矣,易,仪,以,艺,伊,意,忆,翼
樟	葬,账,展,粘,章,长,占,掌,涨,脏,障,仗,张,战,沾,丈,胀,帐,站
菊	巨,距,惧,拒,聚,俱,举,居,据,剧,局,矩,拘,句,具
扶	抚,忽,副,服,湖,富,糊,乎,赋,复,夫,傅,妇,覆,幅,肤,呼,父,佛,辅,伏,付,胡,符,户,互,弗,腹,赴,咐,缚,浮,府,福,护,虎,腐,辐,负,甫,附
千	前,强,潜,迁,钱,歉,谦,遣,墙,欠,腔,签,抢,纤,浅,铅,牵,枪
介	借,界,截,街,价,姐,皆,劫,捷,戒,届,杰,接,洁,竭,阶,节,结,解,揭
谱	扑,铺,葡,仆,朴,普
菠	玻,拨,勃,脖,博,播,膊,波,剥,驳,搏,伯,卜
垛	躲,多,夺,朵
闹	市,老,牢,捞,脑,恼,劳
缚	抚,扶,忽,副,服,湖,富,糊,博,乎,赋,复,夫,傅,妇,覆,幅,肤,呼,父,佛,辅,搏,伏,付,胡,符,户,互,弗,腹,赴,咐,浮,薄,府,福,护,虎,腐,辐,负,甫,附
蜜	迷,秘,弥,米,密,必,泌
郎	懒,篮,烂,栏,滥,嚷,囊,浪,拦,兰,廊,览,让,蓝,朗,狼,壤
靡	迷,秘,蜜,魔,弥,米,密,泌,磨,摩,麻
胡	抚,扶,忽,副,服,湖,富,糊,乎,赋,复,夫,傅,妇,覆,幅,肤,呼,父,佛,辅,伏,付,符,户,互,弗,腹,赴,咐,缚,浮,府,福,护,虎,腐,辐,负,甫,附
娥	恶,鹅,鄂,俄,我,饿,额
颇	婆,迫,泊,破,泼,坡
得	德,地,的
技	基,挤,肢,集,济,鸡,寂,脊,际,机,既,疾,祭,及,辑,支,吉,迹,级,急,鼓,极,歧,积,饥,即,几,击,己,绩,肌,激,忌,计,季,继,寄,籍,剂,记,枝,纪
哩	逆,黎,厉,梨,理,李,利,立,离,礼,吏,厘,莉,历,隶,你,丽,拟,尼,励,力,里,泥,日,例,粒,璃
萌	蒙,猛,门,们,梦,盟,闷,孟
垂	摧,吹,脆,锤,催,粹,睡,崔,翠
旨	字,执,肢,滞,址,姿,致,稚,志,直,滋,制,脂,织,支,汁,知,纸,指,资,兹,自,职,止,质,紫,芝,值,智,之,置,秩,治,子,至,殖,植,只,枝
玖	舅,究,旧,久,酒,救,九,纠,就
波	披,博,剥,彼,伯,玻,拨,勃,脖,播,搏,被,坡,皮,驳,皱,膊,疲,破,卜
耿	坑,跟,耕,更,根
煮	阻,柱,堵,驻,租,署,贮,绪,嘱,主,祝,助,筑,珠,足,者,住,竹,铸,赌,逐,组,都,祖,诸,猪,朱,株,族,注
持	词,次,池,齿,寺,瓷,刺,磁,驰,此,辞,耻,诗,斥,特,等,尺,迟,慈,吃,翅,雌,待,赤
废	菲,黑,匪,肥,肺,非,嘿,费,飞,沸
破	玻,披,皮,波,疲,婆,迫,泊,彼,被,皱,泼,颇,坡
阔	括,国,扩,过,闭,闯,郭,锅,门,闪,裹,闷,果,闲
修	羞,绣,袖,秀,休,朽
症	诊,争,整,珍,振,惩,政,侦,挣,证,睁,镇,歪,增,阵,郑,真,针,蒸,震,贞,正,征
驹	巨,距,惧,拒,聚,俱,举,居,据,剧,菊,局,矩,拘,句,具
肌	基,挤,集,济,鸡,寂,脊,际,机,既,疾,祭,技,及,辑,吉,迹,凯,级,急,极,积,饥,即,几,击,己,绩,激,忌,计,季,继,寄,籍,剂,记,纪
梗	坑,跟,耕,硬,更,便,根
韵	孕,允,运,匀,晕,云,蕴
毅	异,逸,役,医,抑,义,一,益,议,疑,亦,乙,姨,宜,蚁,椅,移,译,疫,谊,亿,已,衣,依,遗,矣,易,仪,以,艺,伊,意,忆,翼
绵	勉,面,棉,免,锦,眠
碎	髓,虽,税,岁,睡,遂,随,水
沽	姑,骨,股,故,苦,固,酷,鼓,雇,咕,库,孤,古,枯,谷,哭,裤,顾,估
匙	市,实,司,寺,尸,四,使,拾,室,适,食,世,私,是,施,逝,势,死,识,师,石,试,诗,始,释,蚀,斯,撕,十,湿,思,式,似,士,示,氏,丝,史,事,饲,视,驶,时,饰,失
帽	茅,貌,冒,毛,茂,贸,猫,矛
挣	诊,争,整,珍,症,振,政,侦,证,睁,镇,增,阵,郑,真,针,蒸,震,贞,正,征
贝	账,贫,卑,北,悲,碑,辈,被,责,倍,货,杯,贪,财,背,贺,备,负
筑	阻,柱,煮,驻,租,贮,嘱,主,祝,助,珠,足,住,竹,铸,逐,组,祖,诸,猪,朱,株,族,注
罪	嘴,最,醉,追
辣	拉,哪,那,腊,辟,娜,拿,辞,呐,钠,辩,宰,辛,辨,蜡,避,啦,纳
比	闭,笔,彼,逼,毕,壁,蔽,鼻,碧,必,币,弊,避,臂
哗	划,话,花,画,滑,化,华
熬	傲,奥,澳,凹
弥	迷,秘,蜜,尔,米,密,泌,你
菲	黑,匪,肥,排,肺,非,嘿,废,悲,辈,费,飞,沸
走	州,越,轴,骤,昼,奏,趣,起,徒,皱,趋,超,宙,趟,洲,周
互	抚,扶,忽,副,服,湖,富,糊,乎,赋,复,夫,傅,妇,覆,幅,肤,呼,父,佛,辅,伏,付,胡,符,户,弗,腹,赴,咐,缚,浮,府,福,护,虎,腐,辐,负,甫,附
禹	与,裕,玉,育,愚,誉,语,豫,遇,雨,宇,愉,喻,于,愈,渔,预,余,予,欲,寓,域,郁,狱,娱,羽,舆,鱼,御,浴
奶	奈,赖,莱,来,乃,耐
彰	葬,账,展,粘,章,长,占,掌,涨,脏,障,仗,张,战,沾,丈,胀,帐,站
师	市,实,司,寺,尸,四,使,拾,室,适,食,世,私,是,施,逝,势,死,识,石,试,诗,始,释,蚀,斯,撕,十,湿,思,式,似,士,示,氏,丝,帅,史,事,饲,视,驶,时,饰,失
壬	忍,仁,任,认,仍,扔,人
呛	前,千,强,潜,迁,钱,歉,谦,遣,墙,欠,腔,签,抢,浅,铅,牵,枪
胁	鞋,携,谢,斜,写,些,协,谐,械,歇,邪,卸,苏,泄,办
押	芽,雅,压,哑,鸦,鸭,崖,牙,呀,亚
镇	诊,争,整,珍,症,振,政,怎,挣,侦,证,睁,阵,郑,真,针,蒸,震,贞,正,征
掷	字,执,肢,滞,址,姿,致,稚,旨,志,直,滋,制,脂,织,支,汁,知,纸,指,资,兹,自,职,止,质,紫,芝,值,智,之,置,秩,治,子,至,殖,植,只,枝
佃	奠,垫,典,淀,电,殿,店,点,颠
厕	测,策,彻,车,扯,撤,册,侧
丝	市,实,司,寺,尸,四,使,拾,室,适,食,世,私,是,施,逝,势,死,识,师,石,试,诗,始,释,蚀,斯,撕,十,湿,思,式,似,士,示,氏,史,事,饲,视,驶,时,饰,失
悴	摧,吹,垂,脆,锤,催,粹,崔,翠
至	字,执,肢,滞,址,姿,致,稚,旨,志,到,直,滋,制,脂,织,支,汁,知,纸,指,资,兹,自,职,止,质,紫,芝,值,智,之,置,倒,秩,治,子,殖,植,只,枝
闰	论,轮,润,伦
钧	匀,峻,军,俊,君,菌,均
笑	效,萧,硝,销,孝,消,晓,校,小,肖
错	猎,蜡,措,借,惜,腊
诡	规,跪,鬼,愧,危,桂,贵,硅,轨,亏,龟,柜,归,脆,溃
参	渗,阐,苍,藏,缠,惨,残,仓,蚕,禅,颤,舱,餐,产
摆	拜,白,柏,败,百
粒	逆,黎,厉,拉,梨,理,李,利,立,离,礼,吏,厘,莉,历,哩,隶,你,丽,拟,尼,励,力,里,泥,日,例,璃,站
慈	词,次,池,齿,瓷,刺,磁,持,滋,驰,此,辞,耻,兹,斥,尺,迟,吃,翅,雌,赤
恬	括,刮,天,乱,甜,填,田,舌,添
瑙	老,闹,牢,捞,脑,恼,劳
标	祭,票,示,彪,表
嫁	驾,夹,架,家,佳,钾,甲,假,加,嘉,贾,稼,价
蒲	铺,谱,扑,搏,辅,普,仆,捕,膊,葡,朴,甫
冲	匆,从,聪,崇,充,丛,虫
携	鞋,写,些,协,卸,斜,谐,械,歇,泄,胁,邪,谢
挖	娃,哇,瓦,蛙
悍	凡,含,范,杭,泛,犯,饭,寒,反,汉,航,贩,罕,烦,番,繁,返,翻,喊,涵,韩,函,旱,汗
揣	瑞,端,喘
坟	冯,风,狠,疯,蜂,份,锋,氛,缝,很,芬,峰,粉,封,凤,奉,丰,粪,奋,恨,愤,逢,分,纷,痕
慨	既,概,改,钙,盖,溉,该,开,凯
吭	坑,垦,耕,肯,更,恳
冻	懂,洞,冬,动,东,董
音	鹰,英,映,姻,吟,赢,影,因,迎,殷,隐,盈,应,印,阴,引,硬,营,颖,婴,饮,银
炮	泡,饱,包,跑,抛,抱
旬	训,讯,寻,迅,询,逊,循,巡
脆	跪,摧,危,吹,垂,锤,催,粹,崔,翠
畴	凑,仇,愁,筹,臭,丑,抽,瞅,酬
摧	吹,垂,脆,锤,催,粹,崔,翠
奇	汽,期,岂,骑,凄,栖,棋,气,椅,齐,旗,起,其,弃,歧,器,企,漆,戚,七,契,启,妻,欺
永	泳,庸,用,涌,拥,勇,脉
渺	描,庙,秒,苗,妙
咏	泳,庸,用,涌,拥,永,勇,脉
堵	渡,煮,署,绪,独,毒,者,肚,杜,赌,读,都,督,诸,度
例	逆,黎,厉,梨,理,李,列,利,立,离,裂,礼,吏,厘,莉,历,哩,隶,你,丽,咧,烈,拟,尼,励,力,里,泥,日,粒,璃
制	字,执,肢,滞,址,姿,致,稚,旨,志,直,滋,脂,织,支,汁,知,纸,指,资,兹,自,职,止,质,紫,芝,值,智,之,置,秩,治,子,至,殖,植,只,枝
换	荒,缓,皇,惶,幻,煌,环,欢,黄,患,晃,慌,唤
铛	氮,胆,单,弹,丹,党,但,当,旦,诞,荡,档,淡,挡,蛋,担
贴	沾,占,粘,站,战,铁
雕	吊,调,掉,周
泽	译,这,择,哲,浙,著,折,者,遮,责,则,着
城	尘,称,程,沉,惩,层,诚,衬,臣,承,呈,趁,曾,盛,陈,成,晨,撑,乘
攀	判,盼,盘,叛,潘,庞,旁,胖
蝴	抚,扶,忽,副,服,湖,富,糊,乎,赋,复,夫,傅,妇,覆,幅,肤,呼,父,佛,辅,伏,付,胡,符,户,互,弗,腹,赴,咐,缚,浮,府,福,护,虎,腐,辐,负,甫,附
股	设,没,姑,役,骨,故,苦,投,固,酷,鼓,雇,咕,库,孤,古,枯,谷,哭,裤,顾,估,般
牧	亩,木,姆,墓,幕,慕,穆,目,母
枕	诊,争,整,珍,症,振,政,怎,挣,侦,证,睁,镇,阵,郑,真,针,蒸,震,贞,正,征
圃	扑,铺,葡,仆,朴,谱,普
晃	荒,缓,皇,惶,幻,煌,环,欢,黄,患,换,慌,唤
锤	摧,吹,垂,脆,催,粹,睡,崔,翠
胀	葬,账,展,粘,章,长,占,掌,涨,脏,障,仗,张,战,沾,丈,帐,站
誓	市,实,司,寺,尸,四,使,拾,室,适,食,世,私,是,施,逝,势,死,识,师,石,试,诗,始,释,蚀,斯,撕,十,湿,思,式,似,士,示,氏,丝,史,事,饲,视,驶,时,饰,失
需	许,序,叙,续,蓄,须,徐,儒,虚,吁,绪
倦	誉,捐,券,卷
胎	台,太,抬,泰,态
熊	胸,兄,凶,雄
卢	努,辱,录,怒,炉,儒,如,露,芦,入,奴,陆,路,鲁,乳,碌,鹿
惜	晰,猎,戏,袭,借,析,悉,腊,稀,习,吸,希,席,西,嘻,锡,细,隙,夕,息,溪,牺,系,错,蜡,措,洗,喜,媳
隋	髓,虽,税,碎,岁,睡,遂,随,水
蜂	冯,风,疯,份,衡,恒,氛,锋,缝,芬,峰,粉,封,凤,奉,丰,粪,蓬,横,奋,哼,逢,分,坟,纷,愤
坛	坦,滩,躺,谈,倘,堂,碳,糖,炭,探,贪,塘,汤,唐,趟,叹,摊
馋	逸,阐,缠,惨,参,肠,厂,唱,尝,偿,残,昌,勉,蚕,场,畅,倡,常,禅,颤,免,餐,挽,晚,产
饲	市,实,司,寺,尸,四,使,拾,室,适,食,世,私,是,施,逝,势,死,识,师,石,试,诗,始,释,蚀,斯,撕,十,湿,思,式,似,士,示,氏,丝,史,事,视,驶,时,饰,失
荒	缓,皇,惶,幻,煌,环,欢,黄,患,换,晃,慌,唤
篮	懒,郎,然,南,烂,难,栏,滥,染,浪,拦,兰,廊,览,临,燃,蓝,监,鉴,男,朗,狼
贷	呆,代,逮,戴,袋,带,待
酿	梁,凉,谅,娘,酒,醉,良,辆,亮,两,粮,念,配,年,酬,量,狼
咋	炸,杂,扎
稻	盗,倒,岛,导,蹈,刀,到,道
宁	龄,铃,另,您,陵,灵,玲,凝,零,领,令,凌,岭
杖	葬,账,展,粘,章,长,占,掌,涨,脏,障,仗,张,战,沾,丈,胀,帐,站
础	储,粗,初,出,楚,促,畜,触,厨,处,除
怠	呆,代,逮,戴,袋,带,待,贷
氏	市,底,实,司,寺,尸,四,使,拾,室,适,食,世,私,是,低,抵,施,逝,势,纸,死,识,师,石,试,诗,始,释,蚀,斯,撕,十,湿,思,式,似,士,示,丝,史,事,饲,视,驶,时,饰,失
撬	侨,乔,悄,敲,巧,桥,瞧
荡	氮,胆,单,弹,丹,党,但,当,旦,诞,档,淡,挡,蛋,担
该	概,慨,改,钙,盖,核,咳,溉,开,刻,凯
具	巨,距,惧,拒,聚,俱,举,居,据,剧,菊,局,矩,拘,句
仪	异,逸,役,医,抑,毅,义,一,益,议,疑,亦,乙,姨,宜,蚁,椅,移,译,疫,谊,亿,已,衣,依,遗,矣,易,以,艺,伊,意,忆,翼
头	投,透,偷
帚	奏,州,宙,昼,洲,走,轴,皱,骤,周
判	盼,半,伴,盘,叛,潘,庞,攀,旁,胖
泉	权,拳,圈,全,劝,券
蔬	诉,疏,束,数,淑,署,树,叔,宿,枢,肃,输,术,属,抒,俗,素,书,鼠,熟,舒,速,苏,塑,述,竖,殊
潭	坦,滩,躺,谈,倘,堂,碳,糖,炭,探,贪,坛,塘,汤,唐,趟,叹,摊
即	基,挤,集,济,鸡,寂,脊,际,机,既,疾,祭,技,及,辑,吉,迹,级,急,极,积,饥,几,击,己,绩,肌,激,忌,计,季,继,寄,籍,剂,记,纪
琢	卓,作,桌,捉,做,逐,左,昨,座,坐
搅	胶,骄,郊,焦,角,脚,较,缴,教,交,轿,娇,叫
馒	忙,蛮,漫,茫,慢,曼,盲,满
脯	育,铺,脊,谱,扑,搏,月,辅,普,仆,捕,朋,膊,背,葡,朴,甫
甩	帅,摔,衰
证	诊,争,整,珍,症,振,惩,政,侦,挣,睁,镇,歪,增,阵,郑,真,针,蒸,震,贞,正,征
讼	宋,松,耸,送,颂
严	焰,氧,阳,厌,言,养,验,颜,洋,央,沿,样,宴,燕,咽,秧,扬,盐,研,眼,炎,艳,烟,延,演,杨,掩,衍,仰,羊,岩
蝙	变,遍,辩,扁,编,辨,鞭,便,边
愿	源,员,元,远,原,渊,怨,圆,援,冤,园,缘,袁,院
虚	虑,序,吁,需,绪,许,叙,须,徐,蓄,续,虎
矫	胶,骄,郊,焦,角,搅,脚,较,缴,教,交,轿,娇,叫
瞅	凑,仇,愁,筹,臭,丑,抽,酬,畴
寓	与,裕,玉,育,愚,誉,语,豫,遇,雨,宇,愉,喻,于,愈,渔,预,余,予,欲,域,郁,狱,娱,羽,舆,鱼,御,浴
票	祭,飘,漂,示,标
刀	盗,倒,岛,稻,导,蹈,到,道
蜻	轻,庆,琴,侵,晴,请,倾,清,猜,氢,亲,青,睛,情,勤,秦
售	收,搜,瘦,兽,受,守,首,寿,手,授
墨	默,黑,莫,漠,摸,沫,陌,膜,摩,末,魔,抹,模,磨
贸	茅,貌,帽,冒,毛,茂,猫,矛
赞	葬,暂,展,粘,潜,占,脏,咱,战,沾,替,站
糯	逻,诺,螺,萝,络,落,裸,洛,罗
孩	海,害,咳,还
姿	次,字,执,肢,滞,址,致,稚,旨,志,直,滋,制,脂,织,支,汁,知,纸,指,资,兹,自,职,止,质,紫,芝,值,智,之,置,秩,治,子,至,殖,植,只,枝
眯	迷,秘,蜜,弥,米,断,密,泌,继
步	不,布,补,捕,部
发	罚,伐,哈,阀,乏,法
呢	乐,了
乐	惹,了,热,呢
则	测,这,择,哲,浙,著,折,者,遮,责,侧,泽,着
虹	鸿,轰,哄,洪,红,宏
暇	夏,下,吓,霞,假,峡,狭,瞎,辖
睬	彩,才,采,菜,材,财,柴,裁,蔡,猜,拆
削	穴,学,血,雪
缘	源,员,元,愿,远,原,渊,怨,圆,援,冤,园,袁,院
联	梁,凉,谅,良,链,耸,耻,辆,恋,亮,职,连,练,炼,两,怜,廉,粮,念,耳,莲,年,量,帘,脸
俘	抚,扶,忽,副,服,湖,富,糊,乎,赋,复,夫,傅,妇,覆,幅,肤,呼,父,佛,辅,伏,付,胡,符,户,互,弗,腹,赴,咐,缚,浮,府,福,护,虎,腐,辐,负,甫,附
稚	字,执,肢,滞,址,姿,致,旨,志,直,滋,制,脂,织,支,汁,知,纸,指,资,兹,自,职,止,质,紫,芝,值,智,之,置,秩,治,子,至,殖,植,只,枝
诵	宋,痛,松,桶,涌,耸,通,送,颂,讼
餐	阐,苍,藏,缠,惨,参,残,仓,蚕,禅,颤,舱,产
秤	尘,称,程,沉,惩,城,层,诚,衬,臣,承,呈,趁,曾,陈,成,晨,撑,乘
咧	劣,裂,猎,捏,烈,例,列
狡	胶,骄,校,郊,焦,角,效,搅,脚,较,缴,教,交,咬,轿,娇,叫
使	市,实,司,寺,尸,四,拾,室,适,食,世,私,是,施,逝,势,死,识,师,石,试,诗,始,释,蚀,斯,撕,十,湿,思,式,似,士,示,氏,丝,史,事,饲,视,驶,时,饰,失
乔	侨,骄,悄,敲,巧,桥,瞧,轿,侨,娇
埠	不,布,步,补,捕,部
鳄	恶,鹅,鄂,俄,饿,额
捐	倦,卷
豫	与,裕,玉,育,愚,誉,语,遇,雨,宇,愉,喻,于,愈,渔,预,余,予,欲,寓,域,郁,狱,娱,羽,舆,鱼,御,浴
牲	生,审,渗,婶,伸,升,身,绳,肾,省,什,慎,圣,声,申,神,剩,深,沈,僧,胜,甚,盛
桦	划,话,哗,花,画,滑,化,华
痪	荒,缓,皇,惶,幻,煌,环,欢,黄,患,换,晃,慌,唤
洒	沙,纱,萨,刹,杀,啥,撒,厦,砂,傻
灼	卓,左,座,桌,作,的,做,昨,捉,坐,约
爽	霜,双
恼	老,闹,牢,捞,脑,劳
峨	恶,鹅,鄂,俄,我,饿,额
衍	焰,氧,阳,厌,严,言,养,验,颜,洋,央,沿,样,宴,燕,咽,秧,扬,盐,研,眼,炎,艳,烟,延,演,杨,掩,仰,羊,岩
甘	杠,看,干,港,感,堪,肝,赶,坎,敢,刊,岗,刚,纲,甜,杆,砍,钢
斑	榜,琴,板,邦,膀,半,傍,伴,帮,班,棒,搬,扮,办,版,颁,王,狂,般
交	胶,骄,校,郊,焦,角,效,搅,脚,较,缴,教,咬,轿,娇,叫
刑	醒,行,杏,兴,新,信,幸,欣,性,型,辛,心,姓,形,星,开
火	货,祸,伙,惑,或,煤,霍,烧,获,炎,活,灾
抗	杠,看,港,康,堪,坑,坎,刊,岗,刚,纲,砍,钢,炕
舅	究,旧,久,酒,救,九,纠,就
阁	葛,格,隔,课,个,歌,棵,哥,可,革,胳,壳,克,各,科,割,渴,客,鸽,颗,刻,戈
早	招,遭,造,罩,爪,灶,找,兆,藻,召,照,燥,糟,赵
京	禁,净,静,惊,金,敬,凉,近,精,谅,劲,锦,筋,镜,津,晋,境,景,竟,浸,尽,巾,经,井,茎,警,颈,竞,掠,进,仅,睛,晶,紧,谨,今,径,斤
塞	寒,赛,晒
枣	招,遭,造,罩,爪,灶,找,早,兆,藻,召,照,燥,糟,赵
斥	词,次,池,齿,瓷,刺,磁,持,驰,此,辞,耻,尺,迟,慈,吃,翅,雌,赤
肉	柔,楼,漏
咬	胶,腰,校,郊,效,要,耀,药,邀,遥,摇,交,姚
屎	市,实,司,寺,尸,四,使,拾,室,适,食,世,私,是,施,逝,势,死,识,师,石,试,诗,始,释,蚀,斯,撕,十,湿,思,式,似,士,示,氏,丝,史,事,饲,视,驶,时,饰,失
瞪	灯,凳,登,等,邓
晒	塞,赛
东	冻,懂,洞,冬,动,董
诲	绘,辉,汇,毁,梅,灰,海,霉,回,慧,惠,恢,挥,徽,会,悔,每
曹	遭,巢,超,操,朝,抄,槽,糟,吵,草,潮
酥	诉,疏,束,数,蔬,淑,署,酒,树,叔,醉,宿,枢,肃,输,术,属,抒,俗,素,书,鼠,熟,舒,速,苏,塑,配,述,酬,竖,殊
宗	忠,仲,纵,终,众,重,总,崇,种,综,钟,衷,中,踪,肿
揩	概,慨,改,钙,盖,溉,该,开,凯
突	涂,土,徒,途,屠,图,兔,吐
焚	冯,风,狠,烧,疯,蜂,份,锋,氛,缝,很,芬,峰,粉,封,凤,炎,奉,丰,粪,灾,煤,奋,恨,愤,逢,分,坟,纷,痕,火
账	葬,展,粘,章,贫,长,占,掌,责,涨,脏,障,货,贪,仗,张,财,战,沾,贝,丈,胀,帐,贺,负,站
颠	奠,垫,典,淀,电,殿,店,点
人	忍,仁,任,认,仍,扔
导	盗,倒,岛,稻,蹈,刀,到,道
饿	恶,鹅,鄂,俄,额
凸	涂,土,徒,途,突,屠,图,兔,吐
巨	距,惧,拒,聚,俱,举,居,据,剧,柜,菊,局,矩,拘,句,具
敢	杠,看,干,港,感,甘,堪,肝,赶,坎,刊,岗,刚,纲,杆,砍,钢
庭	停,艇,亭,听,厅,廷,挺
鄙	闭,笔,比,彼,逼,毕,壁,蔽,鼻,碧,必,币,弊,避,臂
晨	辱,尘,称,程,沉,惩,振,唇,城,诚,衬,臣,承,呈,趁,震,陈,成,撑,乘
斋	摘,窄,寨,宰,再,灾,在,载,宅,债,仔,栽
雅	芽,押,压,哑,鸦,鸭,崖,牙,呀,亚
尺	词,次,池,齿,瓷,刺,磁,持,驰,此,辞,耻,斥,迟,慈,吃,翅,雌,赤
角	胶,骄,郊,焦,搅,脚,较,缴,教,交,轿,娇,叫
锈	修,羞,绣,袖,透,秀,休,诱,朽
肾	生,审,渗,婶,伸,升,身,绳,省,什,慎,圣,声,申,牲,神,剩,深,沈,胜,甚,盛,森
蛛	阻,柱,煮,驻,租,贮,嘱,主,祝,助,筑,珠,足,住,竹,铸,逐,组,祖,诸,猪,朱,株,族,注
入	辱,录,炉,儒,如,露,芦,陆,路,鲁,乳,碌,卢,鹿
谆	准,遵,尊
剩	生,审,渗,婶,伸,升,身,绳,肾,省,什,慎,圣,声,申,牲,神,深,沈,僧,胜,甚,盛
藕	偶,欧
缤	饼,兵,冰,滨,并,丙,宾,病
写	鞋,些,协,卸,斜,谐,携,械,歇,泄,胁,邪,谢
绣	修,羞,袖,透,秀,休,诱,朽
乾	前,千,强,潜,迁,钱,歉,谦,遣,墙,欠,腔,签,抢,浅,铅,牵,枪
咐	抚,扶,忽,副,服,湖,富,糊,乎,赋,复,夫,傅,妇,覆,幅,肤,呼,父,佛,辅,伏,付,胡,符,户,互,弗,腹,赴,缚,浮,府,福,护,虎,腐,辐,负,甫,附
淹	焰,氧,阳,厌,严,言,养,验,颜,洋,央,沿,样,宴,燕,咽,秧,俺,扬,盐,研,眼,炎,艳,烟,延,演,杨,掩,衍,仰,羊,岩
畏	慰,委,胃,惟,威,味,围,危,伟,未,为,位,伪,谓,尾,卫,维,纬,微,魏,喂,唯,违
彻	测,策,切,车,扯,撤,册,侧
漫	忙,蛮,茫,慢,曼,盲,满
胶	骄,校,郊,焦,角,效,搅,脚,较,缴,教,交,咬,轿,娇,叫
疟	掠,略
旺	万,汪,往,网,湾,忘,亡,完,玩,顽,望,碗,挽,晚,妄,王,弯
蜕	退,腿,推
印	鹰,英,映,姻,吟,赢,影,因,迎,殷,隐,盈,应,阴,引,硬,营,颖,婴,音,饮,银
卧	窝,我,握
较	胶,骄,郊,焦,角,搅,脚,缴,教,交,轿,娇,叫
绞	胶,骄,校,郊,焦,角,效,搅,脚,较,缴,教,交,咬,轿,娇,叫
算	酸
扮	榜,斑,板,邦,膀,半,傍,伴,帮,班,棒,搬,办,版,颁,般
撰	状,壮,赚,转,装,撞,砖,钻,庄,专
喳	咋,炸,杂,扎
游	友,优,由,又,邮,犹,油,幽,悠,右,忧,有,诱,幼,尤
辞	词,次,池,齿,瓷,刺,磁,持,驰,辟,此,耻,斥,辩,宰,尺,辛,辨,辣,迟,慈,吃,避,翅,雌,赤
畅	阐,苍,藏,缠,肠,厂,唱,尝,偿,昌,仓,场,倡,舱,常,禅,颤,产
估	姑,骨,股,故,苦,固,酷,鼓,雇,咕,库,孤,古,枯,谷,哭,裤,顾
请	轻,庆,琴,侵,晴,倾,清,氢,亲,青,情,勤,秦
理	逆,黎,厉,梨,李,利,立,离,童,礼,吏,厘,莉,历,埋,著,哩,隶,你,丽,拟,尼,励,力,里,泥,日,例,粒,璃
睹	渡,煮,署,绪,独,毒,者,肚,杜,赌,读,都,督,诸,堵,度
狞	龄,铃,另,您,陵,灵,玲,凝,零,领,令,凌,岭,宁
薯	诉,疏,束,数,蔬,淑,署,树,叔,宿,枢,肃,输,术,属,抒,俗,素,书,鼠,熟,舒,速,苏,塑,述,竖,殊
足	阻,柱,煮,驻,租,贮,嘱,主,祝,助,筑,珠,住,竹,铸,逐,组,祖,诸,猪,朱,株,族,注
好	耗,豪,浩,号,毫
锻	短,断,段,端
整	诊,争,珍,症,振,政,侦,挣,证,睁,镇,增,阵,郑,真,针,蒸,震,贞,正,征
呕	偶,欧
屋	物,吴,五,乌,雾,舞,无,务,污,悟,午,伍,呜,武,吾,误
淮	怀,坏
舱	苍,藏,惨,参,肠,厂,唱,尝,偿,残,昌,仓,蚕,场,畅,倡,常,餐
副	抚,扶,忽,服,湖,富,糊,乎,逼,赋,复,夫,傅,妇,覆,幅,肤,呼,父,佛,辅,伏,付,胡,符,户,互,弗,腹,赴,咐,缚,浮,府,福,护,虎,腐,辐,负,甫,附
罗	逻,弱,诺,螺,萝,若,络,落,裸,洛
溪	晰,戏,袭,析,悉,稀,习,吸,希,席,西,嘻,锡,细,隙,夕,息,牺,系,惜,洗,喜,媳
雳	逆,黎,厉,梨,理,李,利,立,离,礼,吏,厘,莉,历,哩,隶,你,丽,拟,尼,励,力,里,泥,日,例,粒,璃
桌	卓,作,捉,做,左,昨,掉,座,坐
一	异,逸,役,医,抑,毅,义,益,议,疑,亦,乙,姨,宜,蚁,椅,移,译,疫,谊,亿,已,衣,依,遗,矣,易,仪,以,艺,伊,意,忆,翼
邦	榜,斑,板,膀,半,傍,伴,帮,班,棒,搬,扮,办,版,颁,般
吧	爸,拔,八,坝,叭,霸,罢,把,巴
包	保,胞,暴,炮,宝,堡,泡,饱,抱,薄,爆,报,跑
姓	生,醒,行,杏,兴,新,信,幸,欣,性,型,辛,心,形,星,刑
并	饼,兵,冰,滨,拼,丙,宾,病
座	卓,作,桌,捉,做,左,昨,坐
锁	所,说,索,缩
拷	高,搞,靠,告,考,稿
啡	菲,黑,匪,肥,肺,非,嘿,废,费,飞,沸
蝉	阐,缠,惨,参,肠,厂,唱,尝,偿,残,昌,蚕,场,畅,倡,常,禅,颤,餐,产
缴	胶,骄,郊,焦,角,搅,脚,较,教,交,轿,娇,叫
注	阻,柱,煮,驻,租,贮,嘱,主,祝,往,助,筑,珠,足,住,竹,铸,逐,组,祖,诸,猪,朱,株,族
此	词,次,池,齿,瓷,刺,磁,持,驰,柴,辞,耻,些,斥,紫,尺,迟,慈,吃,翅,雌,赤
衣	异,逸,役,医,抑,毅,义,一,益,议,疑,亦,乙,姨,宜,蚁,椅,移,译,疫,谊,亿,已,依,遗,矣,易,仪,以,艺,伊,意,忆,翼
素	诉,疏,束,数,蔬,淑,署,树,叔,宿,枢,肃,输,术,属,抒,俗,书,鼠,熟,舒,速,苏,塑,述,竖,殊
凌	淋,龄,铃,另,磷,邻,陵,灵,玲,凝,林,零,临,领,令,岭,宁
匣	夏,下,吓,霞,峡,狭,瞎,辖
环	荒,坏,缓,皇,惶,幻,煌,不,欢,黄,患,换,晃,慌,唤
傍	榜,斑,板,邦,膀,半,伴,帮,班,棒,搬,扮,办,版,颁,旁,般
派	排,牌,拍
鼓	肢,姑,骨,股,故,苦,技,支,固,酷,雇,歧,咕,库,孤,古,枯,谷,哭,裤,顾,枝,估
虽	髓,税,碎,岁,睡,遂,随,水
胰	异,逸,役,医,抑,毅,义,一,益,议,疑,亦,乙,姨,宜,蚁,椅,移,译,疫,谊,亿,已,衣,依,遗,矣,易,仪,以,艺,伊,意,忆,翼
筏	罚,伐,哈,阀,乏,法,发
局	巨,距,惧,拒,聚,俱,举,居,据,剧,菊,矩,拘,句,具
侣	绿,女,虑,旅,铝,率,履,吕,律,氯,驴
吏	逆,黎,厉,梨,理,李,利,立,离,礼,厘,莉,历,哩,隶,你,丽,拟,尼,励,力,里,泥,日,例,粒,璃
歧	汽,肢,期,岂,骑,凄,栖,技,棋,气,奇,支,齐,旗,鼓,起,其,弃,器,企,漆,戚,七,契,枝,启,妻,欺
猎	劣,裂,错,蜡,措,借,捏,烈,腊,咧,惜,列
器	汽,期,岂,骑,凄,栖,棋,气,奇,齐,旗,起,其,弃,歧,企,漆,戚,七,契,启,妻,欺
饮	鹰,英,映,姻,吟,赢,影,因,迎,殷,隐,坎,盈,应,印,阴,引,硬,吹,欢,营,欠,颖,婴,音,银
屯	吞
骆	弱,落,螺,诺,萝,各,洛,络,路,逻,若,裸,罗
这	择,哲,浙,著,折,者,遮,责,则,泽,着
汗	凡,含,范,杭,泛,犯,饭,寒,反,汉,航,贩,罕,烦,番,繁,返,翻,喊,涵,韩,函,旱
或	货,祸,伙,惑,霍,获,活,火
共	控,贡,功,宫,巩,工,恭,洪,攻,恐,哄,孔,弓,供,空,公
芬	冯,风,狠,疯,蜂,份,锋,氛,缝,很,峰,粉,封,凤,奉,丰,粪,奋,恨,愤,逢,分,坟,纷,痕
架	驾,夹,家,嫁,佳,钾,甲,假,加,嘉,贾,稼,价
夜	业,叶,野,爷,冶,也,液,页
失	市,实,司,寺,尸,四,使,拾,室,适,食,世,私,是,施,逝,势,死,识,师,石,试,诗,始,释,蚀,斯,撕,十,湿,思,式,似,士,示,氏,丝,史,事,饲,视,驶,时,饰
圈	权,拳,全,劝,泉,券
拍	排,怕,陌,牌,白,泊,伯,柏,帕,派
羞	修,绣,袖,秀,休,朽
竞	禁,净,静,惊,金,京,敬,近,精,劲,锦,筋,镜,津,晋,境,景,竟,浸,尽,巾,经,井,茎,警,颈,进,仅,睛,晶,紧,谨,今,径,斤
咖	卡
肆	市,实,司,寺,尸,四,使,拾,室,适,食,世,私,是,施,逝,势,死,识,师,石,试,诗,始,释,蚀,斯,撕,十,湿,思,式,似,士,示,氏,丝,史,事,饲,视,驶,时,饰,失
西	晰,戏,袭,析,悉,稀,习,吸,希,席,嘻,锡,细,隙,夕,息,溪,牺,系,惜,洗,喜,媳
冶	业,叶,野,爷,夜,也,液,页
嫩	能
牌	排,卑,碑,拍,脾,派
吗	马,蚂,嘛,驱,麻,驰,妈,码,驼,玛,骂
艺	异,逸,役,医,抑,毅,义,一,益,议,疑,亦,乙,姨,宜,蚁,椅,移,译,疫,谊,亿,已,衣,依,遗,矣,易,仪,以,伊,意,忆,翼
起	汽,越,期,走,岂,骑,凄,栖,棋,气,奇,齐,旗,趣,其,弃,歧,徒,器,企,漆,趋,超,戚,趟,七,契,启,妻,欺
砚	焰,氧,觉,阳,现,厌,严,言,养,验,颜,见,洋,央,沿,样,宴,燕,咽,秧,扬,盐,研,眼,炎,艳,烟,延,演,杨,观,掩,衍,仰,羊,视,岩
绑	榜,斑,板,邦,膀,半,傍,伴,帮,班,棒,搬,扮,办,版,颁,般
芝	字,执,肢,滞,址,姿,致,稚,旨,志,泛,直,滋,制,脂,织,支,汁,知,纸,指,资,兹,自,职,止,质,紫,值,智,之,置,秩,治,子,乏,至,殖,植,只,枝
催	摧,吹,垂,脆,锤,粹,崔,翠
捉	卓,作,桌,做,左,昨,座,坐
桨	碱,蒋,讲,匠,简,见,减,尖,箭,键,降,姜,剪,渐,奖,剑,件,健,建,江,疆,检,坚,将,兼,监,肩,鉴,间,艰,舰,僵,践,奸,歼,浆
肺	菲,黑,匪,肥,非,嘿,废,费,飞,沸
瞄	描,庙,猫,秒,苗,妙
擅	上,衫,赏,珊,陕,三,商,散,善,伤,闪,山,扇,尚
霞	夏,下,吓,假,峡,狭,瞎,辖
消	萧,孝,笑,校,梢,效,稍,晓,小,肖,悄,哨,硝,销
福	抚,扶,忽,副,服,湖,富,糊,乎,逼,赋,复,夫,傅,妇,覆,幅,肤,呼,父,佛,辅,伏,付,胡,符,户,互,弗,腹,赴,咐,缚,浮,府,护,虎,腐,辐,负,甫,附
遥	姚,咬,摇,腰,邀,瑶,要,耀,药
烟	焰,氧,阳,厌,严,言,养,验,颜,洋,央,沿,样,宴,燕,咽,秧,扬,盐,研,眼,炎,艳,延,演,杨,掩,衍,仰,羊,岩
篷	棚,碰,膨,朋,峰,蜂,喷,捧,逢,缝,锋,彭,盆,蓬
谜	迷,秘,蜜,弥,米,密,泌
稼	驾,夹,架,家,嫁,佳,钾,甲,假,加,嘉,贾,价
拎	淋,龄,冷,铃,另,您,磷,邻,陵,灵,玲,林,零,临,怜,领,令,凌,岭
杆	杠,看,干,港,感,甘,堪,肝,赶,坎,敢,刊,岗,刚,纲,砍,钢
疏	诉,束,数,蔬,淑,署,树,叔,宿,枢,肃,输,术,属,抒,俗,素,书,鼠,熟,舒,速,苏,塑,述,竖,殊
束	诉,疏,数,蔬,淑,署,树,叔,宿,枢,肃,输,术,属,抒,俗,素,书,鼠,熟,舒,速,苏,塑,述,竖,殊
蚀	市,实,司,寺,尸,四,使,拾,室,适,食,世,私,是,施,逝,势,死,识,师,石,试,诗,始,释,斯,撕,十,湿,思,式,似,士,示,氏,丝,史,事,饲,视,驶,时,饰,失
班	榜,斑,琴,板,邦,膀,半,傍,伴,帮,棒,搬,扮,办,版,颁,王,狂,般
垦	坑,跟,肯,恨,狼,娘,狠,根,恳
楷	概,慨,改,谐,钙,皆,盖,溉,该,开,凯
祖	阻,柱,煮,驻,租,贮,嘱,主,祝,助,筑,珠,足,住,竹,铸,逐,组,诸,猪,朱,株,族,注
痢	逆,黎,厉,梨,理,李,利,立,离,礼,吏,厘,莉,历,哩,隶,你,丽,拟,尼,励,力,里,泥,日,例,粒,璃
躯	取,屈,趣,驱,渠,欧,区,去,曲,趋
项	享,宪,显,乡,象,献,鲜,线,香,县,贤,想,现,翔,祥,箱,掀,橡,相,腺,弦,仙,嫌,响,详,险,限,先,纤,陷,像,湘,向,闲
懈	鞋,写,些,协,卸,斜,谐,携,械,歇,泄,胁,邪,谢
羔	高,搞,靠,告,考,稿
敛	梁,凉,谅,良,链,辆,恋,亮,连,练,炼,联,两,怜,廉,粮,念,莲,年,量,帘,脸
捻	娘,链,恋,连,练,炼,联,怜,廉,念,莲,年,帘,脸
榴	柳,纽,流,瘤,硫,刘,牛,留,溜,扭,六
桩	状,壮,赚,转,装,撞,砖,庄,专
纵	忠,仲,从,终,众,重,总,宗,种,综,钟,衷,丛,中,踪,肿
逛	广,贯,惯,罐,光,况,框,官,观,冠,管,灌,关,馆,狂,矿
蟀	帅,甩,摔,率,衰
胜	生,审,渗,婶,伸,升,身,绳,肾,省,什,慎,圣,声,申,牲,神,剩,深,沈,僧,甚,盛
茂	茅,貌,帽,冒,毛,贸,猫,矛
蘑	墨,陌,魔,莫,默,抹,模,漠,膜,摸,磨,摩,末,沫
控	功,宫,巩,工,孔,贡,弓,供,空,共,公,攻,恐,恭
韭	舅,究,旧,久,酒,救,九,纠,就
凰	荒,缓,皇,惶,幻,煌,环,欢,黄,患,换,晃,慌,唤
尼	逆,黎,厉,梨,理,李,利,立,离,礼,吏,厘,莉,历,哩,隶,你,丽,拟,励,力,里,泥,例,粒,璃
雷	泪,霜,蕾,类,勒,雨,内,累,雾,雪
骚	稍,扫,梢,少,嫂,绍,哨,烧
夯	含,杭,妨,房,寒,防,汉,仿,航,纺,方,罕,喊,涵,韩,放,芳,函,访,旱,汗
霜	湘,雨,雷,箱,相,爽,双,雾,雪
料	辽,疗,鸟,僚,尿,斗,聊,抖,科
献	享,项,宪,显,乡,象,鲜,线,香,县,贤,想,现,翔,祥,箱,掀,橡,相,腺,弦,仙,嫌,响,详,险,限,先,纤,陷,像,湘,向,闲
祝	阻,柱,煮,驻,租,贮,嘱,主,助,筑,珠,足,住,竹,铸,逐,组,祖,诸,猪,朱,株,族,注
老	闹,牢,扰,捞,脑,恼,劳,饶,绕
柑	杠,看,干,港,感,甘,堪,肝,赶,坎,敢,刊,岗,刚,纲,甜,杆,砍,钢
纱	沙,萨,刹,少,洒,杀,啥,妙,抄,撒,厦,砂,傻
签	前,千,强,潜,迁,验,脸,钱,歉,谦,遣,墙,检,欠,腔,险,抢,浅,铅,牵,枪
吵	巢,超,操,朝,抄,曹,槽,草,潮
寒	凡,含,范,杭,泛,犯,饭,反,汉,航,贩,罕,烦,番,繁,赛,返,塞,翻,喊,涵,韩,函,旱,汗
甸	奠,垫,典,淀,电,殿,店,点,颠,句
霸	爸,拔,八,坝,叭,吧,罢,把,巴
绪	煮,序,吁,需,署,许,叙,须,者,徐,蓄,赌,都,诸,续,虚,堵
操	巢,超,朝,抄,曹,槽,藻,吵,草,潮,燥
绍	稍,扫,梢,少,嫂,哨,烧
玉	与,裕,育,愚,誉,语,豫,遇,雨,宇,愉,喻,于,愈,渔,预,余,予,欲,寓,域,郁,狱,娱,羽,舆,鱼,御,浴
粗	础,储,初,出,楚,促,畜,触,厨,处,除
刹	沙,纱,萨,洒,杀,啥,撒,厦,砂,傻
婚	浑,魂,昏,混
管	广,贯,馆,惯,灌,宽,官,罐,观,冠,关,光,款
荫	鹰,英,映,姻,吟,赢,影,因,迎,殷,隐,盈,应,印,阴,引,硬,营,颖,婴,音,饮,银
儿	耳,而,尔,二
圾	基,挤,集,济,鸡,寂,脊,际,机,既,疾,祭,技,吸,及,辑,吉,迹,级,急,极,积,饥,即,几,击,己,绩,肌,激,忌,计,季,继,寄,籍,剂,记,纪
锡	晰,戏,袭,析,悉,稀,习,吸,希,席,踢,西,嘻,细,隙,夕,息,溪,牺,系,惜,易,洗,喜,媳
毫	耗,豪,浩,好,号,毛
茄	驾,夹,架,家,嫁,佳,钾,甲,假,加,嘉,贾,稼,价
世	市,实,司,寺,尸,四,使,拾,室,适,食,私,是,施,逝,势,死,识,师,石,试,诗,始,释,蚀,斯,撕,十,湿,思,式,似,士,示,氏,丝,蝶,史,事,饲,视,驶,时,饰,失,泄
烧	嫂,绍,梢,饶,稍,哨,炎,煤,灾,绕,扫,少,火
拇	亩,木,牧,姆,墓,幕,慕,穆,目,母
树	诉,疏,束,数,蔬,淑,署,叔,宿,枢,肃,输,术,属,抒,俗,素,书,鼠,熟,舒,速,苏,塑,述,竖,殊
祠	词,次,池,齿,瓷,刺,磁,持,驰,此,辞,耻,斥,尺,迟,慈,吃,翅,雌,赤
能	嫩,愣,冷
冈	杠,干,港,康,感,甘,肝,赶,敢,岗,刚,纲,抗,杆,钢,炕
圣	生,审,渗,婶,伸,升,身,绳,肾,省,什,慎,声,申,牲,神,剩,深,沈,僧,胜,甚,盛
祸	货,伙,惑,或,霍,锅,获,活,火
到	致,盗,倒,岛,稻,导,蹈,刀,至,道
菱	淋,龄,铃,另,磷,邻,陵,灵,玲,凝,林,零,临,领,令,凌,岭,宁
样	群,焰,氧,鲜,阳,厌,严,言,养,验,颜,洋,央,沿,宴,燕,咽,秧,扬,盐,研,眼,炎,艳,烟,延,演,杨,详,掩,衍,仰,羊,岩
砸	咋,炸,杂,扎
梢	嫂,绍,烧,稍,肖,悄,哨,扫,销,少,硝,消
链	梁,金,凉,谅,良,钱,键,铜,辆,恋,亮,连,练,炼,联,两,怜,廉,针,粮,念,莲,年,量,帘,脸
倒	致,盗,岛,稻,导,蹈,刀,到,至,道
蜀	诉,疏,束,数,蔬,淑,署,树,叔,宿,枢,肃,输,术,属,抒,俗,素,书,鼠,熟,舒,速,苏,塑,述,竖,殊
谋	某,煤,媒
认	忍,仁,任,仍,扔,人
广	贯,惯,罐,光,况,框,官,观,冠,管,灌,关,馆,狂,矿
炫	悬,选,旋,玄,宣
庞	判,盼,拢,笼,盘,叛,潘,攀,旁,龙,垄,胖
崭	暂,账,展,粘,章,长,占,掌,涨,障,渐,仗,张,咱,战,沾,丈,胀,赞,帐,站
溯	诉,疏,束,数,蔬,淑,署,树,叔,宿,枢,肃,输,术,属,抒,俗,素,书,鼠,熟,舒,速,苏,塑,述,竖,殊
抢	前,千,强,潜,迁,钱,歉,谦,仓,遣,墙,白,欠,腔,签,浅,铅,牵,枪
耳	职,而,尔,儿,联,耸,耻,二
钱	前,千,强,金,潜,线,迁,链,歉,键,铜,残,谦,遣,墙,欠,腔,针,签,抢,浅,铅,践,牵,枪
刺	词,次,池,齿,瓷,磁,持,驰,此,辞,耻,斥,尺,迟,慈,吃,翅,雌,赤
歼	碱,蒋,讲,匠,简,见,减,尖,箭,键,降,姜,剪,渐,奖,剑,件,健,建,江,疆,检,坚,将,兼,监,肩,鉴,间,艰,舰,僵,践,奸,浆
太	台,抬,泰,胎,态
桐	筒,痛,童,桶,通,统,铜,同
煌	荒,缓,皇,惶,幻,环,欢,黄,患,换,晃,慌,唤
汛	训,讯,旬,寻,迅,询,逊,循,巡
津	禁,净,静,惊,金,京,敬,近,精,劲,锦,筋,镜,晋,境,景,竟,浸,尽,巾,经,井,律,茎,警,颈,竞,进,仅,睛,晶,紧,谨,今,径,斤
拨	玻,勃,脖,博,播,膊,波,剥,驳,搏,伯,卜
锄	础,储,粗,初,出,楚,促,畜,触,厨,处,除
妒	渡,杜,户,督,赌,独,毒,炉,房,堵,读,肚,度,驴
戊	物,吴,五,乌,雾,舞,屋,无,务,污,悟,午,伍,呜,武,吾,误
婿	许,序,叙,续,蓄,须,需,徐,虚,吁,绪
疚	舅,究,旧,久,酒,救,九,纠,就
业	叶,野,爷,夜,冶,也,液,页
务	物,吴,五,乌,雾,舞,屋,无,污,悟,午,伍,呜,武,吾,误
逼	副,闭,笔,比,彼,毕,幅,壁,蔽,鼻,碧,必,币,弊,福,避,臂
示	市,实,司,寺,尸,四,使,拾,室,适,食,世,私,祭,是,施,逝,势,死,识,师,石,试,诗,始,释,蚀,斯,撕,十,湿,思,票,式,似,士,氏,丝,史,事,饲,视,驶,时,饰,失,标
榨	咋,炸,杂,扎
欧	驱,躯,区,偶
亢	杠,看,港,康,堪,坑,坎,刊,岗,刚,纲,抗,砍,钢,炕
鲁	努,辱,录,怒,炉,儒,如,露,芦,入,奴,陆,路,乳,碌,卢,鹿
平	频,苹,品,凭,拼,屏,瓶,萍,贫,评
悬	选,旋,玄,宣
措	猎,错,蜡,借,惜,腊
侨	乔,悄,敲,巧,桥,瞧
煽	上,衫,赏,珊,陕,三,商,散,善,伤,闪,山,扇,尚
限	享,项,宪,显,乡,象,献,鲜,线,香,县,贤,想,现,翔,祥,箱,掀,橡,相,腺,弦,仙,嫌,响,详,险,先,纤,陷,像,湘,向,闲
齐	挤,汽,济,期,岂,骑,凄,栖,棋,气,奇,旗,起,其,弃,歧,器,企,漆,戚,剂,七,契,启,妻,欺
悠	游,友,优,由,又,邮,犹,油,幽,右,忧,有,诱,幼,尤
各	葛,格,隔,课,个,歌,棵,哥,可,革,胳,壳,阁,克,科,割,渴,洛,客,鸽,颗,络,路,刻,戈
急	基,挤,集,济,鸡,寂,脊,际,机,既,疾,祭,技,及,隐,辑,吉,迹,级,极,积,饥,即,几,击,己,绩,肌,稳,激,忌,计,季,继,寄,籍,剂,记,纪
月	曰,朋,越,膊,育,岳,约,背,悦,跃,脊,阅
卿	轻,庆,琴,侵,晴,请,倾,清,氢,亲,青,情,勤,秦
分	冯,风,狠,疯,蜂,份,锋,氛,缝,很,芬,峰,粉,封,凤,奉,丰,粪,奋,恨,愤,逢,坟,纷,痕
晰	戏,袭,近,析,悉,稀,习,吸,希,席,西,浙,嘻,锡,细,隙,夕,息,溪,牺,系,拆,惜,哲,折,洗,喜,媳,斤
泵	奔,笨,本
瓦	娃,哇,挖,蛙
跳	条,挑
焦	胶,骄,郊,角,搅,脚,较,缴,教,交,轿,娇,叫
恒	冯,风,狠,宣,疯,蜂,衡,锋,缝,很,峰,封,凤,奉,丰,横,恨,哼,逢,痕
椅	异,逸,役,医,抑,毅,义,一,益,议,疑,亦,乙,奇,姨,宜,蚁,移,译,疫,谊,亿,已,衣,依,遗,矣,易,仪,以,艺,伊,意,忆,翼
点	奠,垫,典,淀,电,殿,店,颠
履	绿,覆,女,虑,旅,铝,率,吕,律,氯,复,驴
坎	看,干,康,感,堪,甘,肝,赶,敢,刊,抗,吹,欢,欠,杆,砍,饮,炕
诬	物,吴,五,乌,雾,舞,屋,无,务,污,悟,午,伍,呜,武,吾,误
肩	碱,蒋,讲,匠,简,见,减,尖,箭,键,降,姜,剪,渐,奖,剑,件,健,建,江,疆,检,坚,将,兼,监,鉴,间,艰,舰,僵,践,奸,歼,浆
专	状,壮,赚,转,装,撞,砖,钻,庄
宿	诉,疏,束,数,蔬,淑,署,树,叔,枢,肃,输,术,缩,属,抒,俗,素,书,鼠,熟,舒,速,苏,塑,述,竖,殊
甫	抚,扶,忽,副,服,湖,富,糊,铺,乎,赋,复,夫,傅,妇,覆,幅,肤,呼,父,佛,辅,搏,伏,付,胡,符,户,互,弗,腹,赴,咐,缚,浮,捕,府,福,膊,护,虎,腐,辐,负,附
鸯	焰,氧,阳,厌,严,言,养,验,颜,洋,央,沿,样,宴,燕,咽,秧,扬,盐,研,眼,炎,艳,烟,延,演,杨,掩,衍,仰,羊,岩
刮	括,瓜,乱,夸,寡,挂,舌,跨
钮	柳,纽,流,瘤,丑,硫,刘,牛,留,溜,扭,六
概	既,慨,改,钙,盖,溉,该,开,凯
叮	顶,打,丁,盯,钉,定,订
踢	体,锡,易,替,题,梯,提
兼	碱,蒋,讲,匠,简,见,减,尖,箭,歉,键,降,姜,剪,渐,谦,奖,剑,件,健,建,江,嫌,疆,检,坚,廉,将,监,赚,肩,鉴,间,艰,舰,僵,践,奸,歼,浆
淀	奠,垫,典,电,殿,店,点,颠
指	字,执,肢,滞,址,姿,致,稚,旨,志,直,滋,制,脂,织,支,汁,知,纸,资,兹,自,职,止,质,紫,芝,值,智,之,置,秩,治,子,至,殖,植,只,枝
再	摘,窄,寨,宰,灾,在,载,宅,债,仔,栽
囱	匆,从,聪,冲,崇,充,丛,虫
贬	变,遍,辩,扁,编,辨,鞭,便,边
关	广,贯,馆,惯,灌,宽,官,罐,观,冠,管,光,款
忿	冯,风,狠,疯,蜂,份,锋,氛,缝,很,芬,峰,粉,封,凤,奉,丰,粪,奋,恨,愤,逢,分,坟,纷,痕
越	超,曰,趣,起,趟,徒,岳,约,悦,跃,月,走,阅,趋
莉	逆,黎,厉,梨,理,李,利,立,离,礼,吏,厘,历,哩,隶,你,丽,拟,尼,励,力,里,泥,日,例,粒,璃
充	匆,从,聪,冲,崇,丛,虫
相	享,项,霜,宪,显,乡,象,献,鲜,线,香,县,贤,想,现,翔,祥,箱,掀,橡,腺,弦,仙,嫌,响,详,险,限,先,纤,陷,像,湘,向,闲
括	国,扩,过,刮,乱,郭,锅,裹,果,阔,舌
嘴	最,罪,醉,追
死	市,实,司,寺,尸,四,使,拾,室,适,食,世,私,是,施,逝,势,识,师,石,试,诗,始,释,蚀,斯,撕,十,湿,思,式,似,士,示,氏,丝,史,事,饲,视,驶,时,饰,失
铲	阐,缠,惨,参,肠,厂,唱,尝,偿,残,昌,蚕,场,畅,倡,常,禅,颤,餐,产
崖	芽,押,鸭,挂,娃,压,哑,桂,牙,蛙,亚,雅,封,佳,鸦,呀
皓	耗,豪,浩,好,号,毫
蜒	焰,氧,阳,厌,严,言,养,验,颜,洋,央,沿,样,宴,燕,咽,秧,扬,盐,研,诞,眼,炎,艳,烟,延,演,杨,掩,衍,仰,羊,岩
灰	绘,辉,汇,毁,碳,炭,回,慧,惠,恢,挥,徽,会,悔
弧	抚,扶,忽,副,服,湖,富,糊,乎,赋,复,夫,傅,妇,覆,幅,肤,呼,父,佛,辅,伏,付,胡,符,户,互,弗,腹,赴,咐,缚,浮,府,福,护,虎,腐,辐,负,甫,附
滇	奠,垫,典,淀,电,殿,店,点,颠
橄	杠,看,干,港,感,甘,堪,肝,赶,坎,敢,刊,岗,刚,纲,杆,砍,钢
侈	词,次,池,齿,够,瓷,刺,磁,持,驰,此,辞,耻,移,多,斥,尺,迟,慈,吃,翅,雌,赤
院	源,员,元,愿,远,原,渊,怨,圆,援,冤,园,缘,袁
动	冻,懂,历,运,洞,励,力,劫,冬,边,云,东,董
滤	绿,女,虑,旅,铝,率,履,吕,律,氯,驴
惑	货,祸,伙,或,霍,获,活,火
委	畏,慰,胃,惟,威,味,围,危,伟,未,为,位,伪,谓,尾,卫,维,纬,微,魏,喂,唯,违
鹤	喝,鸣,盒,合,鸟,鹅,何,贺,荷,岛,赫,呵,河,核,和
哉	摘,窄,寨,宰,再,灾,在,载,宅,债,仔,栽
段	短,锻,断,端
俯	抚,扶,忽,副,服,湖,富,糊,乎,赋,复,夫,傅,妇,覆,幅,肤,呼,父,佛,辅,伏,付,胡,符,户,互,弗,腹,赴,咐,缚,浮,府,福,护,虎,腐,辐,负,甫,附
宴	焰,氧,阳,厌,严,言,养,验,颜,洋,央,沿,样,燕,咽,秧,扬,盐,研,眼,炎,艳,烟,延,演,杨,掩,衍,仰,羊,岩
丘	球,求,秋
遇	与,裕,玉,育,愚,誉,语,豫,雨,宇,愉,喻,于,愈,渔,预,余,予,欲,寓,域,郁,狱,娱,羽,舆,鱼,御,浴
梁	凉,谅,娘,良,链,辆,恋,亮,连,练,炼,联,两,怜,廉,粮,莲,量,帘,脸
疗	辽,鸟,料,僚,尿,聊,疼,病,瘦
没	股,设,美,妹,投,役,梅,般,枚,煤,每,霉,眉,媒
施	市,实,司,寺,尸,四,使,拾,室,适,食,世,也,私,驰,是,逝,势,死,识,师,石,试,诗,始,释,蚀,斯,撕,十,湿,思,式,似,士,示,氏,丝,史,事,饲,视,驶,时,饰,失
蛤	罚,伐,哈,阀,乏,法,发
免	勉,面,挽,晚,逸,棉,绵,眠
赖	奈,莱,来,乃,奶,耐
砾	逆,黎,厉,梨,理,李,利,立,离,礼,吏,厘,莉,历,哩,隶,你,丽,乐,拟,尼,励,力,里,泥,日,例,粒,璃
央	焰,氧,映,阳,厌,严,言,养,验,颜,洋,沿,样,宴,燕,咽,秧,扬,盐,研,眼,炎,艳,烟,延,演,杨,掩,衍,仰,羊,岩
房	凡,炉,范,杭,泛,犯,妨,饭,反,仿,航,纺,驴,方,贩,户,烦,番,繁,返,翻,放,芳,防,访
必	闭,笔,比,彼,逼,毕,壁,蔽,鼻,蜜,碧,密,秘,币,弊,避,臂
蕉	胶,骄,郊,焦,角,搅,脚,较,缴,教,交,轿,娇,叫
氢	轻,庆,琴,侵,晴,请,倾,清,亲,青,情,勤,秦
缀	嘴,最,罪,醉,追
殴	偶,欧
瞩	阻,柱,煮,驻,租,贮,嘱,主,祝,助,筑,珠,足,住,竹,铸,逐,组,祖,诸,猪,朱,株,族,注
魔	默,莫,漠,摸,麻,沫,陌,膜,摩,末,墨,抹,模,磨
招	遭,造,罩,爪,灶,找,早,兆,藻,召,照,燥,糟,赵
截	借,界,介,街,姐,皆,劫,捷,戒,届,杰,接,洁,竭,阶,节,结,解,揭
旱	凡,含,范,杭,泛,犯,饭,寒,反,汉,航,贩,罕,烦,番,繁,返,翻,喊,涵,韩,函,汗
饰	市,实,司,寺,尸,四,使,拾,室,适,食,世,私,是,施,逝,势,死,识,师,石,试,诗,始,释,蚀,斯,撕,十,湿,思,式,似,士,示,氏,丝,史,事,饲,视,驶,时,失
地	德,的,得
逮	呆,绿,代,录,剥,戴,袋,碌,带,待,贷
姻	鹰,英,映,吟,赢,影,因,迎,殷,隐,盈,应,印,阴,引,硬,营,颖,婴,音,饮,银
待	呆,代,诗,寺,逮,戴,特,袋,等,带,贷,持
陷	享,项,宪,显,乡,象,献,鲜,线,香,县,贤,想,现,翔,祥,箱,掀,橡,相,腺,弦,仙,嫌,响,详,险,限,先,纤,像,湘,向,闲
怒	努,录,鲁,露,炉,路,鹿,芦,碌,奴,卢,陆
害	海,咳,还,孩
萤	鹰,英,映,姻,吟,赢,影,因,迎,殷,隐,盈,应,印,阴,引,硬,营,颖,婴,音,饮,银
贻	异,逸,役,医,抑,毅,义,一,益,议,疑,亦,乙,姨,宜,蚁,椅,移,译,疫,谊,亿,已,衣,依,遗,矣,易,仪,以,艺,伊,意,忆,翼
涮	酸,霜,爽,双,算
徊	怀,坏,淮
损	员,瞬,顺,孙
赚	谦,状,壮,转,装,撞,砖,歉,嫌,钻,兼,廉,庄,专
苞	保,胞,暴,包,炮,宝,堡,泡,饱,抱,薄,爆,报,跑
氓	忙,蛮,漫,茫,慢,曼,盲,满
草	巢,超,操,朝,抄,曹,槽,吵,潮
医	异,逸,役,抑,毅,义,一,益,议,疑,亦,乙,姨,宜,蚁,椅,移,译,疫,谊,亿,已,衣,依,遗,矣,易,仪,以,艺,伊,意,忆,翼
雾	物,吴,霜,五,乌,雨,舞,屋,无,务,污,悟,午,伍,呜,雷,武,雪,吾,误
沙	纱,萨,刹,少,洒,杀,啥,妙,抄,撒,厦,砂,傻
滩	坦,躺,谈,倘,堂,难,碳,糖,炭,探,贪,坛,塘,汤,唐,趟,叹,摊
垃	钠,立,粒,辣,拉,娜,蜡,拿,站,哪,啦,那,呐,纳,腊
躁	招,遭,造,罩,爪,灶,找,早,兆,藻,召,照,燥,操,糟,赵
盾	敦,顿,蹲,吨
耸	宋,职,耳,松,联,送,耻,颂,讼
侍	市,实,司,寺,尸,四,使,拾,室,适,食,世,私,是,施,逝,势,死,识,师,石,试,诗,始,释,蚀,斯,撕,十,湿,思,式,似,士,示,等,特,氏,丝,史,事,饲,视,驶,时,饰,失,待,持
昔	晰,猎,戏,袭,借,析,悉,腊,稀,习,吸,希,席,西,嘻,锡,细,隙,夕,息,溪,牺,系,惜,错,蜡,措,洗,喜,媳
兄	胸,熊,凶,雄
腔	前,千,强,潜,迁,钱,歉,谦,遣,墙,欠,签,抢,浅,铅,牵,枪
过	括,国,扩,寸,守,郭,锅,村,讨,裹,衬,时,对,果,阔,付
籍	基,挤,集,济,鸡,寂,脊,际,机,既,疾,祭,技,及,辑,吉,迹,级,急,极,积,饥,即,几,击,己,绩,肌,激,忌,计,季,继,寄,剂,记,纪
枚	没,美,妹,梅,煤,每,霉,眉,媒
舒	诉,疏,束,数,蔬,淑,署,树,叔,宿,枢,肃,输,术,属,抒,俗,素,书,鼠,熟,速,苏,塑,述,竖,殊
碳	坦,滩,躺,谈,倘,堂,灰,糖,炭,探,贪,坛,塘,恢,汤,唐,趟,叹,摊
宝	报,堡,薄,爆,饱,包,保,胞,抱,暴
量	梁,凉,谅,娘,良,链,辆,恋,亮,连,练,炼,联,两,怜,廉,粮,莲,帘,脸
擒	轻,庆,琴,侵,晴,请,倾,清,氢,亲,青,情,勤,秦
樱	鹰,英,映,姻,吟,赢,影,因,迎,殷,隐,盈,应,印,阴,引,硬,营,颖,婴,音,饮,银
新	醒,行,杏,兴,信,幸,欣,性,型,辛,心,姓,形,星,刑
场	阐,苍,藏,缠,肠,厂,唱,尝,偿,昌,仓,扬,畅,倡,舱,常,禅,颤,杨,汤,产
瞎	夏,下,吓,霞,峡,狭,辖
衅	醒,行,杏,兴,新,信,幸,欣,性,型,辛,心,姓,形,星,刑
绰	卓,错,措,掉,桌
颅	努,辱,录,怒,炉,儒,如,露,芦,入,奴,陆,路,鲁,乳,碌,卢,鹿
毛	茅,貌,帽,冒,茂,贸,猫,毫,矛
磕	葛,格,隔,课,个,歌,棵,哥,可,革,胳,壳,阁,克,各,科,割,渴,客,鸽,颗,刻,戈
栋	冻,懂,洞,冬,动,东,董
避	闭,笔,比,彼,逼,毕,壁,辟,蔽,辞,鼻,碧,辩,宰,必,辛,币,弊,辨,辣,臂
湾	万,汪,往,网,忘,亡,旺,完,玩,顽,望,碗,挽,晚,妄,王,弯
腻	逆,黎,厉,梨,理,李,利,立,离,礼,吏,厘,莉,历,哩,隶,你,丽,拟,尼,励,力,里,泥,例,粒,璃
席	晰,戏,袭,析,悉,稀,习,吸,希,西,嘻,锡,细,隙,夕,息,溪,牺,系,惜,洗,喜,媳
朵	躲,多,夺
惋	万,汪,往,网,湾,忘,亡,旺,完,玩,顽,望,碗,挽,晚,妄,王,弯
鉴	碱,篮,蒋,讲,匠,简,见,减,尖,箭,键,降,姜,剪,渐,奖,剑,件,健,建,江,疆,检,坚,临,将,兼,蓝,监,肩,间,艰,舰,僵,践,奸,歼,浆
鸵	托,拖,驼,脱,妥
慕	莫,亩,漠,墓,幕,母,木,牧,姆,模,穆,摸,目
亩	木,牧,姆,墓,幕,慕,穆,目,母
知	字,执,肢,滞,址,姿,致,稚,旨,志,直,滋,制,脂,织,支,汁,纸,指,资,兹,自,职,止,质,紫,芝,值,智,之,置,秩,治,子,至,殖,植,只,枝
囤	敦,顿,蹲,吨,盾
仑	论,轮,润,伦
祥	享,项,宪,显,乡,象,献,鲜,线,香,县,贤,想,现,翔,箱,掀,橡,相,腺,弦,仙,嫌,响,详,险,限,先,纤,陷,像,湘,向,闲
俊	峻,军,君,菌,均
妙	沙,纱,描,少,抄,庙,秒,苗
衙	芽,押,雅,压,哑,鸦,鸭,崖,牙,呀,亚
酵	胶,骄,郊,焦,角,搅,脚,较,缴,教,交,轿,娇,叫
慷	杠,看,港,康,堪,坎,刊,岗,刚,纲,抗,砍,钢,炕
跺	躲,多,夺,朵
拂	抚,扶,忽,副,服,湖,富,糊,乎,赋,复,夫,沸,傅,妇,覆,幅,肤,呼,父,佛,辅,伏,付,胡,符,户,互,弗,腹,赴,咐,缚,浮,府,福,护,虎,腐,辐,负,甫,附
阀	罚,伐,哈,乏,法,发
帷	畏,慰,委,胃,惟,威,味,围,危,伟,未,为,位,伪,谓,尾,卫,维,纬,微,魏,喂,唯,违
膊	博,育,剥,铺,伯,脊,玻,拨,勃,脖,播,波,搏,月,辅,驳,捕,朋,背,甫,卜
怪	块,拐,快
粘	暂,贴,账,展,章,长,占,掌,涨,障,仗,张,咱,战,沾,丈,胀,赞,帐,站
奋	冯,风,狠,疯,蜂,份,锋,氛,缝,很,芬,峰,粉,封,凤,奉,丰,粪,恨,愤,逢,分,坟,纷,痕
械	鞋,写,些,协,卸,斜,谐,携,歇,泄,胁,邪,谢
市	实,司,寺,尸,四,使,拾,室,适,食,世,私,是,施,逝,势,死,识,师,石,试,诗,始,释,蚀,斯,撕,十,湿,思,式,似,士,示,氏,丝,闹,史,事,饲,视,驶,时,饰,失
富	抚,扶,忽,副,服,湖,糊,乎,赋,复,夫,傅,妇,覆,幅,肤,呼,父,佛,辅,伏,付,胡,符,户,互,弗,腹,赴,咐,缚,浮,府,福,护,虎,腐,辐,负,甫,附
擦	叉,插,察,茶,差,查
裹	括,国,扩,过,郭,锅,果,阔
贿	绘,辉,慧,灰,惠,会,恢,汇,挥,悔,毁,徽,回
谎	荒,缓,皇,惶,幻,煌,环,欢,黄,患,换,晃,慌,唤
吨	敦,顿,蹲,盾
挠	老,闹,牢,绕,捞,脑,饶,烧,恼,劳
索	所,说,锁,缩
咽	焰,氧,阳,厌,严,言,养,验,颜,洋,央,沿,样,宴,燕,秧,扬,盐,研,眼,炎,艳,烟,延,演,杨,掩,衍,仰,羊,岩
稀	晰,戏,袭,析,悉,习,吸,希,席,西,嘻,锡,细,隙,夕,息,溪,牺,系,惜,洗,喜,媳
苏	诉,疏,束,数,蔬,淑,署,树,叔,宿,枢,肃,输,术,属,协,抒,俗,素,书,鼠,熟,胁,舒,速,塑,述,竖,殊,办
声	生,审,渗,婶,伸,升,身,绳,肾,省,什,慎,圣,申,牲,神,剩,深,沈,僧,胜,甚,盛
乏	罚,伐,哈,阀,芝,泛,法,发,之
夫	抚,扶,忽,副,服,湖,富,糊,乎,赋,大,复,傅,妇,覆,幅,肤,呼,父,佛,辅,伏,付,胡,符,户,互,弗,腹,赴,咐,缚,浮,府,福,天,护,虎,腐,辐,负,甫,附
史	市,实,司,寺,尸,四,使,拾,室,适,食,世,私,是,施,逝,势,死,识,师,石,试,诗,始,释,蚀,斯,撕,十,湿,思,式,似,士,示,氏,丝,事,饲,视,驶,时,饰,失
谤	榜,斑,板,邦,膀,半,傍,伴,帮,班,棒,搬,扮,办,版,颁,般
掘	屈,出,觉,决,绝
式	市,实,司,寺,尸,四,使,拾,室,适,食,世,私,是,施,逝,势,死,识,师,石,试,诗,始,释,蚀,斯,撕,十,湿,思,似,士,示,氏,丝,史,事,饲,视,驶,时,饰,失
完	远,万,汪,往,网,湾,忘,园,亡,元,旺,玩,顽,望,碗,挽,晚,妄,王,弯
隘	矮,爱,碍,哎,挨,哀,埃,唉,艾
诀	缺,掘,块,快,觉,决,绝
难	懒,蓝,栏,览,滥,男,篮,囊,滩,南,摊,拦,兰,烂
豁	货,祸,谷,裕,伙,惑,或,俗,霍,浴,获,活,火
疆	碱,蒋,讲,匠,简,见,减,尖,箭,键,降,姜,剪,渐,奖,剑,件,健,建,江,检,坚,将,兼,监,肩,鉴,间,艰,舰,僵,践,奸,歼,浆
唧	基,挤,集,济,鸡,寂,脊,际,机,既,疾,祭,技,及,辑,吉,迹,级,急,极,积,饥,即,几,击,己,绩,肌,激,忌,计,季,继,寄,籍,剂,记,纪
妹	没,美,梅,枚,煤,每,霉,眉,媒
涉	社,设,色,舍,摄,蛇,射,舌
酝	孕,允,运,匀,晕,云,蕴,韵
凹	傲,奥,澳
愁	凑,仇,筹,臭,丑,抽,瞅,酬,秋,畴
娇	胶,骄,桥,侨,郊,焦,角,搅,乔,脚,较,缴,教,交,轿,叫
诗	市,实,司,寺,尸,四,使,拾,室,适,食,世,私,是,施,逝,势,死,识,师,石,试,始,释,蚀,斯,撕,十,湿,思,式,似,士,示,等,特,氏,丝,史,事,饲,视,驶,时,饰,失,待,持
馆	广,贯,惯,灌,宽,官,罐,观,冠,管,关,光,款
漠	默,莫,慕,摸,沫,陌,墓,幕,膜,摩,末,墨,魔,抹,模,磨
奈	赖,莱,来,乃,奶,耐
晦	绘,辉,汇,毁,梅,灰,海,霉,回,慧,惠,恢,挥,徽,会,悔,每
岭	淋,龄,冷,铃,另,磷,邻,陵,灵,玲,凝,林,零,临,怜,领,令,凌,宁
精	禁,净,静,惊,金,京,敬,近,劲,锦,筋,镜,津,晋,境,景,竟,浸,尽,巾,经,井,茎,警,颈,竞,进,仅,睛,晶,紧,谨,今,径,斤
学	穴,血,雪,削
邑	异,逸,役,医,抑,毅,义,一,益,议,疑,亦,乙,姨,宜,蚁,椅,移,译,疫,谊,亿,已,衣,依,遗,矣,易,仪,以,艺,伊,意,忆,翼
胃	畏,慰,委,惟,威,味,围,危,伟,未,为,位,伪,谓,尾,卫,维,纬,微,魏,喂,唯,违
页	领,业,叶,烦,野,爷,须,顺,夜,顽,冶,也,液
护	抚,扶,忽,副,服,湖,富,糊,乎,赋,复,夫,傅,妇,覆,幅,肤,呼,父,佛,辅,伏,付,胡,符,户,互,弗,腹,赴,咐,缚,浮,府,福,虎,腐,辐,负,甫,附
穷	穴,空
十	市,实,司,寺,尸,四,使,拾,室,适,食,世,私,是,施,逝,势,死,识,师,石,试,诗,始,释,蚀,斯,撕,湿,思,式,似,士,示,氏,丝,史,事,饲,视,驶,时,饰,失
画	划,话,哗,花,滑,化,华
递	底,帝,弟,低,抵,蒂,第,滴,迪,堤,敌
户	抚,扶,忽,副,服,湖,富,糊,炉,乎,赋,复,夫,傅,妇,覆,幅,肤,呼,父,房,佛,辅,伏,付,胡,符,驴,互,弗,腹,赴,咐,缚,浮,府,福,护,虎,腐,辐,负,甫,附
饺	胶,骄,校,郊,焦,角,效,搅,脚,较,缴,教,交,咬,轿,娇,叫
狰	诊,争,整,珍,症,振,政,侦,挣,证,睁,镇,增,阵,郑,真,针,蒸,震,贞,正,征
钩	扣,狗,够,口,构,沟,购,勾
澜	懒,郎,篮,然,南,烂,难,栏,滥,染,浪,拦,兰,廊,览,燃,蓝,男,朗,狼
代	呆,逮,戴,袋,带,待,贷
挤	基,集,济,鸡,寂,脊,际,机,既,疾,祭,技,及,辑,吉,齐,迹,级,急,极,积,饥,即,几,击,己,绩,肌,激,忌,计,季,继,寄,籍,剂,记,纪
划	话,哗,花,画,滑,化,华
垄	农,绒,溶,熔,容,笼,浓,融,龙,隆,荣,拢,弄,庞
睛	禁,净,静,惊,金,京,敬,近,精,劲,锦,筋,镜,津,晋,境,晴,景,竟,浸,尽,巾,经,井,清,猜,茎,警,颈,竞,进,仅,青,情,晶,紧,谨,今,径,斤
猩	醒,行,杏,兴,新,信,幸,欣,性,型,辛,心,姓,形,星,刑
娟	捐,倦,卷
伊	异,逸,役,医,抑,毅,义,一,益,议,疑,亦,乙,姨,宜,蚁,椅,移,译,疫,谊,亿,已,衣,依,遗,矣,易,仪,以,艺,意,忆,翼
匾	变,遍,辩,扁,编,辨,鞭,便,边
让	朗,郎,嚷,然,壤,染,浪,燃,狼,廊
半	判,榜,斑,板,邦,膀,傍,伴,帮,班,棒,搬,扮,办,叛,版,颁,般
崛	掘,觉,决,绝
购	扣,钩,狗,够,口,构,沟,勾
辖	夏,下,吓,霞,峡,狭,瞎
男	懒,蓝,难,栏,览,滥,篮,囊,南,拦,兰,烂
展	暂,账,粘,章,长,占,掌,涨,障,仗,张,咱,战,沾,丈,胀,赞,帐,站
疑	异,逸,役,医,抑,毅,义,一,益,议,亦,乙,姨,宜,蚁,椅,移,译,疫,谊,亿,已,衣,依,遗,矣,易,仪,以,艺,伊,意,忆,翼
脚	胶,骄,郊,焦,角,搅,较,缴,教,交,轿,娇,叫
披	彼,脾,玻,辟,波,被,坡,皮,皱,譬,匹,疲,疲,破,屁,批
申	生,审,渗,婶,伸,升,身,绳,肾,省,什,慎,圣,声,牲,神,剩,深,沈,胜,甚,盛,森
像	享,项,宪,显,乡,象,献,鲜,线,香,县,贤,想,现,翔,祥,箱,掀,橡,相,腺,弦,仙,嫌,响,详,险,限,先,纤,陷,湘,向,闲
忘	万,汪,往,网,湾,亡,旺,完,玩,顽,望,碗,挽,晚,妄,王,弯
棒	榜,斑,板,捧,邦,膀,半,傍,伴,帮,班,奉,搬,扮,办,版,颁,般
旦	氮,胆,坦,单,弹,丹,党,但,当,诞,荡,档,淡,挡,蛋,担
径	禁,净,静,惊,金,京,敬,近,精,劲,锦,筋,镜,津,晋,境,景,竟,浸,尽,巾,经,井,茎,警,颈,竞,进,仅,睛,晶,紧,谨,今,斤
庆	轻,琴,侵,晴,请,倾,清,氢,亲,青,情,勤,秦
蚓	鹰,英,映,姻,吟,赢,影,因,迎,殷,隐,盈,应,印,阴,引,硬,营,颖,婴,音,饮,银
薄	博,保,胞,暴,傅,包,搏,宝,堡,饱,抱,缚,爆,报
岔	叉,插,擦,察,茶,差,查
苛	葛,格,隔,课,个,歌,棵,哥,可,革,胳,壳,阁,克,各,科,割,渴,客,鸽,颗,刻,戈
喝	盒,合,何,贺,荷,竭,赫,呵,河,核,揭,渴,和
鼎	顶,丁,叮,盯,钉,定,订
扔	忍,仁,任,认,愣,冷,仍,人
箩	逻,弱,诺,螺,萝,若,络,落,裸,洛,罗
梯	体,踢,替,题,提
末	墨,陌,魔,莫,默,抹,模,漠,膜,摸,磨,摩,沫
曙	诉,疏,束,数,蔬,淑,署,树,叔,宿,枢,肃,输,术,属,抒,俗,素,书,鼠,熟,舒,速,苏,塑,述,竖,殊
锯	巨,距,惧,拒,聚,俱,举,居,据,剧,菊,局,矩,拘,句,具
拐	块,快,怪
胳	葛,格,隔,课,个,歌,棵,哥,可,革,壳,阁,克,各,科,割,渴,客,鸽,颗,刻,戈
他	她,它,塔,拓,踏
靶	爸,拔,八,坝,叭,吧,霸,罢,把,巴
窄	摘,寨,宰,再,灾,在,载,宅,债,仔,栽
瞻	暂,账,展,粘,章,长,占,掌,涨,障,仗,张,咱,战,沾,丈,胀,赞,帐,站
卓	作,桌,捉,做,左,昨,掉,座,坐
本	体,奔,笨
绚	悬,选,旋,玄,宣
朗	懒,郎,篮,烂,栏,滥,嚷,囊,浪,拦,兰,廊,览,让,蓝,狼,壤
毕	闭,笔,比,彼,逼,壁,蔽,鼻,碧,必,币,弊,避,臂
蠕	辱,录,炉,儒,如,露,芦,入,陆,路,鲁,乳,碌,卢,鹿
爬	怕,帕
唆	所,说,锁,索,缩
渠	取,屈,趣,驱,躯,区,去,曲,趋
肋	乐,惹,了,热,呢
宠	匆,从,聪,拢,冲,笼,庞,崇,充,龙,丛,虫,垄
葬	障,丈,暂,账,胀,赞,帐,掌,仗,张,咱,章,长,涨,脏
恶	鹅,鄂,俄,饿,额
踊	泳,庸,用,涌,拥,永,勇
廉	梁,凉,谅,良,链,歉,辆,恋,亮,谦,连,练,炼,联,两,嫌,怜,兼,粮,念,赚,莲,年,量,帘,脸
拆	才,晰,近,析,采,浙,材,柴,裁,蔡,财,猜,彩,哲,菜,折,斤
遏	恶,鹅,鄂,俄,饿,额
符	抚,扶,忽,副,服,湖,富,糊,乎,赋,复,夫,傅,妇,覆,幅,肤,呼,父,佛,辅,伏,付,胡,户,互,弗,腹,赴,咐,缚,浮,府,福,护,虎,腐,辐,负,甫,附
薪	醒,行,杏,兴,新,信,幸,欣,性,型,辛,心,姓,形,星,刑
背	育,脊,卑,北,悲,碑,辈,被,月,倍,杯,贝,朋,膊,备
透	绣,投,偷,秀,头,诱
坝	爸,拔,八,叭,吧,霸,罢,把,巴
球	求,丘,秋
窟	姑,骨,股,故,苦,固,酷,鼓,雇,咕,库,孤,古,枯,谷,哭,裤,顾,估
弟	底,帝,递,低,抵,蒂,第,滴,迪,堤,敌
辉	绘,汇,毁,灰,回,慧,惠,恢,军,挥,徽,晕,会,浑,悔
赤	词,次,池,齿,瓷,刺,磁,持,驰,此,辞,耻,斥,尺,迟,慈,吃,翅,雌
啦	钠,辣,拉,娜,蜡,拿,哪,那,呐,纳,腊
车	测,策,彻,扯,撤,册,侧
唠	老,闹,牢,扰,捞,脑,恼,劳,饶,绕
直	字,执,肢,滞,址,姿,致,稚,旨,志,滋,制,脂,织,支,汁,知,纸,指,资,兹,自,职,止,质,紫,芝,值,智,之,置,秩,治,子,至,殖,植,只,枝
伏	抚,扶,忽,副,服,湖,富,糊,乎,赋,复,夫,傅,妇,覆,幅,肤,呼,父,佛,辅,付,胡,符,户,互,弗,腹,赴,咐,缚,浮,府,福,护,虎,腐,辐,负,甫,附
舀	姚,咬,摇,腰,邀,要,耀,稻,药,遥,蹈
甥	生,审,渗,婶,伸,升,身,绳,肾,省,什,慎,圣,声,申,牲,神,剩,深,沈,僧,胜,甚,盛
崔	摧,吹,垂,脆,锤,催,粹,翠
穿	川,船,闯,创,床,串,窗,传,喘
鹰	英,映,姻,吟,赢,影,因,迎,殷,隐,盈,应,印,阴,引,硬,营,颖,婴,音,饮,银
卦	刮,瓜,夸,寡,挂,跨
阅	曰,越,岳,约,悦,跃,月
歇	鞋,写,些,协,卸,斜,谐,携,械,泄,胁,邪,谢
歌	葛,格,隔,课,融,个,棵,哥,可,革,胳,壳,阁,克,各,科,割,渴,客,鸽,颗,刻,戈
块	缺,拐,快,决,怪
厨	础,储,粗,初,出,楚,促,畜,触,处,除
奄	掩,俺
彦	颜
瑶	遥,摇
弈	亦,变,蛮,迹,恋
奕	亦,变,蛮,迹,恋
驿	择,泽,译
甬	痛,桶,涌,通
俑	痛,桶,涌,通
柚	袖,由,油,庙,抽,邮,迪
杈	权,又
窈	穴,穷,空,幼
坳	幼
鳅	愁,鱼,鲜,秋
鲇	鱼,鲜
俞	愉,喻,偷,愈,输
瑜	愉,喻,偷,愈,输
翱	翔,翻,翅,羽
霆	挺,霜,艇,庭,廷,雷,雾,雨,雪
聿	律,津
肓	育,膊,朋,背,月,脊
芸	运,云,动
铡	测,侧,则
黏	沾,占,贴,粘,战,站
獐	章,障
窕	挑,穴,桃,兆,穷,空,逃
躇	煮,诸,赌,者,堵,署,绪,都
岐	鼓,技,肢,歧,支,枝
枳	职,织,只,识
凋	调,雕,周
淙	崇,宗,综,踪
孚	浮
摞	螺,累
沤	驱,欧,躯,区
仞	忍
趵	的,约
湛	甚,堪
豕	逐
踌	涛,铸,筹,寿
殳	股,设,没,投,役,般
厮	斯,撕
特	寺,等,待,诗,持
恃	寺,特,等,待,诗,持
瞠	堂,堂,霜,湘,箱,相
憧	撞,童
蜿	碗
虻	亡,忙
桅	脆,危,跪
韦	纬,伟
瑕	假,霞
遐	假,霞
鞘	稍,销,硝,悄,消,哨,梢,肖
睄	稍,销,硝,悄,消,哨,梢,肖
诮	稍,销,硝,悄,消,哨,梢,肖
帩	稍,销,硝,悄,消,哨,梢,肖
辨	辟,辣,辩,宰,辞,避,辛
舷	弦,玄
眩	弦,玄
胯	夸,污,跨
笠	立,拉,粒,站
潦	了
燎	了
镣	了
冽	裂,列,例,咧,烈
嶙	磷
粼	磷
麟	磷
遛	溜,瘤,留
茏	拢,笼,庞,龙,垄
偻	数,楼
褛	数,楼
蒌	数,楼
纶	论,轮,伦
幔	慢,曼,漫
冕	晚,勉,挽,逸,免
娩	晚,勉,挽,逸,免
腼	面
盂	监,盒,猛,盐,孟,盆
柩	栖,木,材,村,林,框
疒	疗,疼,病,瘦
疲	玻,披,皮,波,破,彼,被,皱,坡
膘	票,飘,漂
跻	齐,挤,济,剂
绮	奇,椅
楔	契
揳	契
佥	验,签,险,检,脸
侨	骄,乔,轿,桥,娇
沏	切,彻
咀	阻,谊,宜,且,组
倩	睛,青,清,情,猜,晴
鬲	隔,融,歌,哥
嗝	隔,融,歌,哥
亘	恒,宣
楦	恒,宣
艮	恨,垦,娘,狠,狼,恳
掼	惯,贯
圭	娃,封,佳,桂,挂,蛙,崖
畦	娃,封,佳,桂,挂,蛙,崖
呙	祸,锅
娲	祸,锅
剐	祸,锅
稞	颗,课,棵,果
给	塔,答,搭,合,拾,哈,恰
曷	喝,竭,揭,渴
黝	黑,默,墨
虔	虎,虑,虚
奂	换
诙	碳,恢,灰,炭
汲	级,极,吸,及
荚	夹,峡,狭
笺	钱,浅,线,践,残
效	胶,交,咬,校,郊
妗	贪,念,今,吟
堇	谨,勤
泾	经,径,劲,茎
儆	警,敬
蜷	誉,倦,券,卷
晖	辉,浑,军,挥,晕
敖	傲
遨	傲
珀	怕,陌,白,拍,泊,柏,伯,帕
佰	宿,缩
咆	泡,饱,包,跑,抱,炮
赊	货,贝,账,贪,财,贺,负,责,贫
贲	喷,愤
敝	蔽,弊
癖	壁,辟,避
迸	并,拼,饼
帛	绵,锦,棉
礴	傅,博,搏,缚,薄
伧	仓,抢,白,枪
嘈	曹,糟,槽,遭
碴	查
刍	皱
邹	皱
湍	瑞,喘,端
陲	睡,锤,垂
棰	睡,垂,锤
枞	丛,众,纵,从
蹬	凳,登
猕	尔,弥,你
霏	菲,排,匪,非,悲,辈
飚	疯,飘,风
飒	疯,飘,风